QUE D EAU	TU ES DOUX	_
C EST TERMINÉ	LES TERRITOIRES	_
VOUS ÊTES D ACCORD MAINTENANT	VOUS ÊTES AIMÉS CORRESPONDANCES	_
QUI L A EMPORTÉ	QUI L A EMPORTÉ	_
DE QUELLE COULEUR	QUEL EST L AVIS DU GOUVERNEMENT	_
JE NE ROUGIS PAS	JE LE REGRETTE	_
IL BOIT DE L EAU	IL BOIT MOINS DE L EAU	_
ÇÀ ET LÀ	CELLE LÀ LÀ	_
C EST SALE	C EST CELLE LÀ	_
NE L ÉTANT PAS	NE L ÉCOUTEZ PAS	_
NOS TROIS FEUILLES	AUTREFOIS IL PÊCHA LUI	_
LA PIRE DES MALADIES	L APPLICATION DE MADEMOISELLE	_
C EST MOI	C EST MOI	_
S IL PÊCHAIT	SI NOUS PÊCHIONS	_
C EST VRAI	C EST VRAI	_
VOUS AVEZ RENDEZ VOUS	VOUS AVEZ REMERCIÉ VOUS LE VOULEZ VOUS	_
IL NE PÊCHE PAS	IL NE PLEUT PAS	_
IL A RAISON	IL A RENCONTRÉ SÉANCE	_
LE TEMPS SERA CHAUD	LE TROUSSEAU SURTOUT	_
LA MAISON EST GRANDE	UN MÉDECIN ÉCONOMIQUE	_
NEUF HEURES ET QUART	NOUS VERRONS À L UTILISATION	_
C EST ELLES	C EST ELLE	_
RENTREZ CHEZ VOUS	RENTRE CHEZ VOUS	_
NE M EN PARLEZ PAS	NE M EN PARLEZ PAS AVEC EUX	_
ELLE S APPELLE BARBARA	ELLE S APPELLE BARBARA	_
GARDEZ VOTRE LANGUE	LA DESCEND DES VOCATIONS	_
TOUT EN FINESSE	TIENS EN EMMÈNERAI ICI	_
NE PLEURE PAS	NE PLEUREZ PAS	_
C EST BON DE MANGER DU LAIT	C EST BON DE MANGER DU LAIT	_
DANS TA CHAMBRE	DANS TA TÊTE	_
ON NE SAIT PAS	ON NE SAIT PAS	_
SIX RUE GOULIN	S IL VOUS PLAIT ÉVIDEMMENT	_
LE GRAND JOUR ARRIVA	NOUS TRANSFERONS À RÉTABLIR LA RÉDACTION	_
C EST JOLI	C EST JOLI	_
ÊTES VOUS SÛR	ET VOUS ÊTES SÛRE	_
TOUTE L ARMÉE RUSSE	TOUTES CLASSIQUES MÉDECINS	_
VOUS AVEZ REÇU MON COURRIER	LEURS ARGUMENTS JOUÉS	_
C ÉTAIT MONSIEUR PICARD	C ÉTAIT MONSIEUR MONSIEUR PUPPONI	_
HI HI HI HI	IL FUT ÉVIDEMMENT	_
TOUS LES ENFANTS	TOUS LES ENFANTS	_
QUI ÊTES VOUS	QU IL EST VOUS	_
JE N Y SUIS PAS OPPOSÉ	JE NE SUIS PAS OCCUPÉ	_
ELLE AIME LIRE	ELLE A L AIR VIEILLE	_
QUI T ACCOMPAGNE	QUI T ACCOMPAGNAIT	_
C EST VOTRE OPINION	C EST VOTRE ENTRAINEUR	_
QUEL EST VOTRE NOM	QUEL EST VOTRE NOM	_
C EST PLUS OU MOINS SALE	C EST PLUS OU MOINS SALE	_
C EST UNE INFAMIE	C EST UNE NOUVELLE MAJORITÉ	_
POURQUOI EST IL VENU	POURQUOI QU EST CE QU IL VEUT	_
LAISSEZ LES ALLER UN PEU	LA SCÈNE EST À L HERBE	_
C EST SUFFISANT	C EST SUFFISAMMENT	_
COMMENT VA VOTRE SŒUR	COMMENT ALLEZ VOTRE SŒUR	_
IL N Y A PAS BEAUCOUP DE MONDE	IL N Y A PAS BEAUCOUP DE MONDE	_
QUI VOUS ACCOMPAGNAIT	QUI VOUS A COMPRIS AIMÉ	_
VOUS PARLEZ ESPAGNOL	VOUS PARLEZ À L ESCOGRIFFE	_
IL EST GRAND TEMPS	LES GRANDES TOMBENT	_
IL FAUT QUE J Y ARRIVE	IL FAUT DES GENS AISÉS	_
CE SERAIT TROP LENT	CE SERAIT UNE AIDE POUR TOI	_
AUCUNE DE CELLES LÀ	AUCUN DE NOUS SOMMES LÀ	_
UN DÉSAVEU CLAIR	À DÉFAUT AVIS DÉFAVORABLE	_
OÙ SONT ILS	OÙ SONT ICI	_
NE NOUS TROMPONS PAS	LES LETTRES NE TROUVES PLUS PARLER	_
COMMENT ÇA VA	COMMENT S APPELLE SAVEZ VOUS	_
DE TEMPS EN TEMPS	DE TEMPS EN TEMPS	_
POURQUOI N Y ALLEZ VOUS PAS	POURQUOI CROYEZ À L ÉVÊQUE ELLE EST VOTRE PART	_
VAS T EN	BABOCHET À PART	_
CE N EST PAS IMPORTANT	CE N EST PAS LA PEINE D ENTENDRE	_
JE PEUX VOUS EN DIRE AUTANT	JE PEUX VOUS EN DIRELIANT DE RETIRER VOTRE TANT	_
C EST UN INSOUMIS	C EST UN ANIMAL	_
LA CRISE APPROCHAIT	LA CRISE À CROCHES	_
ET ELLE SE RETIRA	ET ELLE SE RÉSIGNAIT	_
VINGT ET UN LIVRES NOIRS	VINGT ET UN ÉLÉPHANTS NOIRS	_
C EST COMME ÇA	C EST QUAND ÇA	_
ÊTES VOUS CERTAIN	ÊTES VOUS SURPRIS ELLE	_
HERVE S OCCUPE DU JARDIN	ELLE VEUT S ENFUIR DU JARDIN	_
COMBAT DE TRAMIN	COMBAT DE TRAVAILLER	_
ELLES SONT PARTIES	ELLES SONT PARTIE	_
CA DURE HUIT JOURS	C EST DUR DU VIEUX JOUE	_
NE M ATTAQUEZ PAS	NE ME METTEZ PAS QU IL EST PART ET PART	_
VOUS ÊTES PRÊT	REPRÉSENTÉS	_
C EST LA RÉALITÉ	C EST LA RÉVÉRATION	_
ELLE EST BIEN	ELLE EST BIENTÔT	_
ELLES VONT TRÈS BIEN	ELLE VONT TRÈS BIEN	_
OÙ SUIS JE	AU SUJET	_
LE PLUS QU IL PEUT	LE PLUS EST S IL PLEUT	_
IL LE FAIT	IL LE FAIT	_
CE N EST PAS VRAI	CE N EST PAS VRAI	_
TU ES SÛR QU ILS AIMAIENT	TU ES SÛR QU ILS AIMAIENT	_
JE N AI PAS D ARGENT	JE N AI PAS D ARGENT	_
ILS VONT TRÈS BIEN	ILS VONT TRÈS BIEN	_
TU AS DE L ARGENT	TU VIENDRAS L ARGENT	_
SI J ÉTAIS	SI J ÉTAIS JET UN ÂNE	_
À LA BONNE HEURE	À LA BOÎTE	_
ÇA M EST ÉGAL	ÇA M EST ÉGAL	_
UN ET DEUX	PAR AILLEURS ELLE EST AIMÉE	_
J AI UN MORCEAU DE CRAIE	J AI UN MORCEAU DE CRAIE	_
MAIS ARRÊTE TOI DONC	LA RÉPUBLIQUE DOMINICATE	_
C EST COMBIEN ÇA	C EST COMBIEN ÇA	_
L OISEAU QUI NE CHANTE PLUS	VOISONS QUI LES CHARMES TOUCHENT	_
UNE TRENTAINE DE KILOS DE BANANES	UNE TRENTAINE D ÉTUDIANTS D Y FUT LONGTEMPS	_
SA BROCHE D OPALE	SA BRANCHE DOIT ON DONNER AUX PLANTES	_
TOI TU LISAIS	TOI TU AS SOIF	_
NEUF HEURES ET DEMI	VOILÀ L IMMENSE	_
EH BIEN NON	EH BIEN ET BIEN NOUS	_
CELA N A RIEN À VOIR	CELA N ARRIVE RIEN À VOIR	_
ET C EST BIEN CE QUI VOUS GÊNE	ET C EST BIEN CE QUE J AI FAIT	_
À QUELLE HEURE VIENT IL	À QUELLE HEURE VIENT IL	_
J ADORE LES HONNÊTES FEMMES	QUEL EST L AVIS DE DEUX AMENDEMENTS IDENTIQUES	_
SURTOUT PARMI VOS AMIS	POURQUOI NE PARLONS PAS NOUVEAU	_
SI J AI DEUX TICKETS	SUIVEZ SES INDICATIONS	_
UNE BONNE CHOSE	UNE BOÎTE AUX CHOUXS	_
C EST PASSIONNANT	FAITES PASSIEURS L HOMME	_
DES PLUS CHERS	DES PLUS CHÈRES	_
DEMAIN ON PÊCHERA	DEMAIN ON PÊCHERA	_
C EST UNE JEUNE FILLE	QU EST CE QUE VOUS AVIEZ FAIT	_
C EST LÀ	C EST LÀ	_
NOUS SAVONS EN FAIRE	NOUS SOMMES VRAIMENT EN FRÈRE	_
UNE PAIRE DE LUNETTES	UNE PAIRE DE LUNETTES LE NOMTRE	_
QUEL ÂGE ONT ILS	KIRSCHBAUM J ARRÊTERAI	_
MA FILLE N EST PAS ICI	MA FILLE N EST PAS ASSEZ	_
C EST UNE ÉVIDENCE	C EST UNE IMMENSE ÉVIDENCE	_
LA DIX HUITIÈME	LA DIFFICULTÉ	_
N Y ALLEZ PAS	N Y ALLEZ PAS	_
COMMENT SONT LES AFFAIRES	COMMENÇONS LES AFFAIRES AFFAIRES	_
ÇA NE ME PLAIT PAS	ÇA NE ME PLAISAIT PAS	_
HEUREUSEMENT QUE C EST UN AMENDEMENT D APPEL	L ENSEIGNEMENT C EST UN AMENDEMENT DE COHÉRENCE	_
UN ÉNORME GÉANT	À L ÉNORME MONSIEUR GICLEFORT	_
JE LE JURE	JE LE JURE	_
C EST LABORIEUX	C EST LA BOLIE	_
CINQ HEURES SONNÈRENT	CINQ ŒUVRES SE MÊRES	_
IL NOUS RESTE À L AMÉNAGER	ILS NE L AVAIENT PAS ÉCOUTÉE	_
C EST REGRETTABLE	C EST REPRÉSENTÉ	_
À QUELLE HEURE VOUS ÊTES VOUS LEVÉ	ACCLAMAIT LEURS LIVRES	_
C ÉTAIT MON AMI	C ÉTAIT MADEMOISELLE	_
QUAND EST CE QUE TU Y VAS	QU EN EST CE QUE TU Y VAS	_
EH BIEN QU EST CE QUE C EST	EH BIEN QU EST CE QUE TU DISAIS ÇA	_
VOUS Y CROYEZ	MONSIEUR CROYAIT	_
SON PRIX EST À 100 EUROS	SON CRI EST PRÊT EST ASSEZ LOIN	_
LA MAISON EST BELLE	À BAISER LES BELLIGÉRANTS	_
JE PARLE DEUX LANGUES	JE PARLE DE DEUX AMENDEMENTS	_
J ACCEPTAI TOUT DE SUITE	J ACCEPTE C ÉTAIT TOUT DE SUITE	_
COMMENT VA TOUT LE MONDE	COMMENT VAS MAINTENANT	_
JE SUIS MARIÉ	JE SUIS TRÈS ENRHUMÉE	_
NOUS Y VOILÀ	NE Z YOUIRA LÀ	_
JE M EN VAIS	JE M EN VAIS	_
C EST LA VIEILLE	C EST L HABITUDE	_
QU EST CE QUE C EST	QU EST CE QUE C EST ÇA	_
A TOI LES JOUISSANCES	ATTRAEZ LES JUSSESANCES	_
J AI HUIT ANS	J AI HUIT ANS	_
C EST LUI	CELUI LÀ	_
TU NE VEUX PAS PARTIR	TU NE VEUX PAS PARTIR	_
IL SE LEVA	AH IL Y EUT LÀ	_
ET LUI FRICOTE SA CUISINE	IL LUI FIT CONTINUA T ILLUSIGNE	_
LE MOULE EN EST BRISE	LE NOUVEAU L ENNEMI BRISSAIT	_
CE N EST PAS LA MÊME CHOSE	C EST MADEMOISELLE CLAIRE	_
UNE VACHE DE QUATRE ANS	UNE VACHE DE CAFÉ	_
VINGT DEUX TABLES	TOME DEUX PAGE DEUX	_
JE N AI PAS DIT LE CONTRAIRE	JE N AI PAS DE CRAYON RÊVE	_
LES ALPES LE SONT	LES HOMMES LE LEÇONS	_
ELLE VA ME TAPER	ELLES AIMERONT TA SŒUR	_
JE VAIS ME COUCHER À 10H30	JE VAIS ME COUCHER À DIFFÉRENTS TYPES CANTANTES	_
UNE BOUTEILLE DE VIN	UNE BOUTEILLE DE VIN	_
ÇA C EST ASSEZ NOUVEAU	ÇA C EST ASSEZ LOIN	_
D UN AIR SOUPÇONNEUX	DAMIENS FUT FOUDROYÉ	_
ILS S ASSEYENT TOUS	ILS S ASSEYENT TOUS	_
UN IMPASSE DU CHAILLOT	ELLE N A PAS BESOIN DE CHIENS	_
LE MORCEAU DE PAIN	LE MORCEAU DE PAIN	_
IL EST CHAUD	IL EST CHAUD	_
IL ARRIVE BIENTÔT	IL ARRIVE BIENTÔT PARTOUT	_
ELLE ELLE AIMAIT	ELLES ELLES AIMAIENT	_
IMPOSSIBLE DE ME RAPPELER	IMPOSSIBLE DE FERMER L APPLICATION	_
ELLE EST LÀ DANS VOTRE PORTE	QUEL EST L AVIS DE LA COMMISSION	_
VENEZ AVEC MOI	DÉVELOPPER À LA RÉPUBLIQUE MOI	_
TOUT LE MONDE	TOUT LE MONDE	_
CELA NE PEUT FONCTIONNER	CELA NE PEUT FAIRE FONCTIONNER	_
C EST TIÈDE	C EST QU IL EST LÀ	_
MERCI MONSIEUR CHASSAIGNE	MERCI MONSIEUR LE SECRÉTAIRE D ÉTAT	_
JE SUIS SÛR QU ELLE AIMAIT	JE SUIS SÛR QU ELLE AIMAIT	_
VOS ENFANTS SONT AVEC VOUS	NOUS EN FONCEONS SUR UN TERRITOIRE	_
C EST VRAI ET NOUS L ASSUMONS	C EST VRAI ET NOUS LAISSE	_
OÙ EST DONC MON PANTALON	OÙ EST DANS MON HÔTEL	_
JE REVIENDRAI PLUS TARD	JE REVIENS À LA RÉPUBLIQUE CULAIRE	_
IL EST TEMPS D Y ALLER	IL EST TOMBÉ DANS LES LÈVRES	_
C EST TROP GRAND	C EST TROP GRAND	_
ON M A DIT D ALLER À L ÉCOLE	ON A DIT D HYDÈNE À L ÉCOLE	_
C EST MA SŒUR AÎNÉE	C EST MA SŒUR AINÉE	_
IL N EST PAS MAUVAIS	IL N EST PAS MALADE	_
MAIS IL EST PARTI	MAIS IL EST PARTI	_
TRENTE QUATRE FEMMES	TRENTE QUATRE FEMMES	_
IL FAIT SEMBLANT	IL FAISAIT SOMBRE	_
VINGT DEUX GRANDES TABLES	ARRÊTE DE REPRODUIRE	_
IL EST 8H45	ET TU LUITTRAS UNE TRENTAINE D ÉTUDIANTS	_
ELLE NE SAIT PAS QUI JE SUIS	ELLE NE SAIT PASTURE SUR LE SUJET	_
N Y ALLEZ PAS	N Y ALLEZ PAS	_
À QUOI SERT ENCORE UN BUDGET	APPLAUDISSEMENTS SUR LES BANCS DU GROUPE SRC	_
DES MALADIES GRAVES	LES MEMBRES DU VINT	_
PORTE ÇA À LA CUISINE	POUR QUE C EST À LA CUISINE PLUTÔT CLASSIQUE LA CUISINE	_
LE THÉÂTRE CELA NE SE POUVAIT	LE TER EST ÊTRE SALADE À ÊTRE CELA NE SE PROMENAIT PLUS	_
C EST BIEN GENTIL	C ÉTAIT GENTIL	_
CHEMIN DES STORTS PASSY	CHEMIN DE D ESPORT PASSIERS ASSIÉ	_
VOULEZ VOUS ME PERMETTRE	VOULEZ VOUS ME PERMETTRE DE PERMETTRE MAÎTRE	_
TRENTE TROIS ÉLÉPHANTS	TRENTE TROIS ÉLÉPHANTS NOIRS	_
JE SERAI AN RETARD	JE SERAIS EN DEUX HEURES DE TARD	_
LES PLUS CHÈRES	LES PLUS CHÈRES	_
VINGT TROIS RUE DE LA TERROIRIE	MAINTENEZ VOUS L OCCASION DE LA TERRITOIRE	_
C EST SIGNÉ DIDIER MIGAUD	LES SYNDICATS QUI N ÉTAIENT QU ILS N ÉTAIENT PAS	_
À LA BONNE HEURE	À LA BONNE HEURE	_
LE BEAU TEMPS	LE BEAU TEMPS	_
IL EST TEMPS	IL EST TEMPS DE TEMPS	_
VOUS VENEZ CE SOIR	VOUS ÊTES SHEILA	_
LE PARTI ÉTAIT BIEN MALADE	LE PARTIE DE BLANCAFORT	_
C EST TON TOUR	C EST TON TOUR	_
ELLES ELLES ONT ÉTÉ AIMÉES	ELLES ELLES ONT ÉTÉ AIMÉES	_
IL N Y A PAS DE CHAISES	IL N Y A PAS DE CHAISES	_
CETTE MAISON LÀ BAS	CETTE MESURE EST NÉCESSAIRE LÀ BAS	_
LA NUIT EST FROIDE	LA NUIT EST FROID	_
ARRÊTEZ DE COURIR	AVEC DES GROSSES	_
JE NE PUIS PLUS L ÊTRE	JE NE PUIS PRIS PLUS L AIR	_
UN PETIT MOMENT S IL VOUS PLAIT	APPLAUDISSEMENTS SUR LES BANCS DU GROUPE SRC	_
JE TENAIS À LE RAPPELER	JE TENAIS À LA RAPPORTE DE RAPPELER	_
À 3 HEURES	À TROIS HEURES	_
C EST LA TIENNE	C EST LA TIENNE	_
J CROIS HABITER UN POT D POMMADE	TU CROIS QU IL CROIT HABITUER UN PEU PLUS MADEMOISELLE PAULINE	_
JE L AI CONNUE	JE L AI CONDUIRE	_
VINGT TROIS TABLES BLANCHES	VINGT TROIS TABLES NOMS BLANCHES	_
QUARANTE NEUF SACS	QUARANTE DEUX MESSIEURS S ACCAAIENT	_
CE QUE C EST QUE D ÊTRE MÉDECIN	CE QUE C EST QUE C ÉTAIT UTILE	_
LES GENS SONT ARRIVÉS	LES GENS SONT ARRIVÉS SONT ARRIVÉS	_
BEAUCOUP DE GENS SONT RESTÉS LÀ BAS	BOCCANEGRA SONT RESPONSASSÉS LÀ BAS	_
IL Y EN A	IL Y EN LÀ	_
AUCUNE AUTRE CHAISE	AU PIED D AUTRES CHAISES	_
VOUS ÊTES FATIGUÉES	VOUS ÊTES FATIGUÉS	_
ON A AIMÉ	ON A EU AIMÉ	_
NOUS EN REPARLERONS	NOUS SERONS RAPIDEMENT POUR LE ROUL	_
PRENEZ GARDE AUX MARCHES	PRENEZ GARDE DEHORS DE MARCHE	_
QUAND IL ARRIVERA	QUAND IL EST INGÉNIEUR	_
CE SONT DES ÉTRANGERS	CE SONT DES AMENDEMENTS IDENTIQUES	_
C EST À VENDRE	C EST À VENDRE	_
NOUS SOMMES LE 25 AOÛT	LE SOLEILHOMME S APPLIQUE À CÔTÉ	_
C EST TROP	C EST TROP	_
ELLES ONT DE CES RAISONNEMENTS	ELLES ONT DE SAIS RÉSERVÉES	_
MAIS CE N EST PAS LE SUJET	MAIS CE N EST PAS LE SUJET	_
PERSONNE D AUTRE	PERSONNELLE D AUTRES	_
C EST LE NUMÉRO DIX SEPT	C EST L UTILISATION DU TEXTE	_
JE SUIS UN VOLEUR C EST VRAI	JE SUIS EN RELATION	_
MOI J AI EU AIMÉ	MOI J AI AIMÉ	_
ELLE VA À CHEVAL	ELLE VA À LA CHEMINÉE	_
ET PUIS BONNARD	ET TU ES BRAS	_
IL APPREND BIEN	QUI L ACCOMPAGNAIT	_
UN ÉNORME TAUREAU	AMÉNAGEMENT LE THÉÂTRE	_
IL FAIT CHAUD	IL FAIT CHAUD	_
ELLES ÉTAIENT VENUS SANS AUCUNE CHAISE	ELLES ÉTAIENT VENUS SANS OUTIL	_
ÇA C EST MARRANT	CA C EST MARRANT	_
ON DÉPLACE L ÉQUILIBRE	ON DESCENDIT LA RÉPUBLIQUE	_
C EST UNE MAISON	C EST UNE MAISON	_
TU ES ICI	TU ES À Y ICI	_
GARÇON OU FILLE	PERSONNE NE S EN FIT IL	_
DES JOUEURS VIOLENTS	DES JOUEURS DE BOULES	_
QUI Y A T IL	QU Y A T IL	_
JEAN NOUS SOMMES VOISINS	JOHN EST LÀ S IL VOUS PLAIT	_
POUR EUX CE SERAIT UNE AIDE	POUR MOI CE SERAIT UNE AIDE NOTE	_
PARLEZ EN AUX ENTREPRISES	PAR LES MAISONS AUX ENTREPRISES ENTREPRISES	_
NOUS COMPRENONS LA MÊME CHOSE	LE COMPROMIS CROYANT LA MÊME CHOSE	_
IL EST VRAI QU ELLE NE M ÉCOUTAIT JAMAIS	IL EST VRAI QU ELLE RECONNAÎT QU ELLE NE L ÉCOUTAIT JAMAIS	_
POURVU QU ELLE NE VIENNE PAS	POURVU QU ELLES NE VIENNENT PAS	_
OÙ EST MA CHEMISE	BONS MES CHERS COLLÈGUES	_
TRENTE DEUX CHEMIN DE CHAURON	TRENTE DEUX CHEMIN DE CHARLES DE CHARNY	_
IL EST BON DE LE RAPPELER	IL EST BON DE RAPPELER	_
ET MOI QUI TE CROYAIS AU BAGNE	QUE VOULEZ VOUS QU IL EÛT AIDÉ À GAUCHE	_
QUE J AI PLEURÉ	QUE J AI CLEURÉ	_
IL A PLU LÀ	IL A PLU LA PLUS LÀ	_
PAS MOYEN D ALLER PLUS LOIN	PAR MORT MUR À LA RÉPUBLIQUE	_
JE VOUS REVERRAI À LA MAIRIE	JE VOUS REMERRAIE À LA MAINE	_
À QUI LA FAUTE	A T IL LA FAUTE	_
JE ME LAVE	JOUE MALADE	_
JE M EN EXPLIQUE	JE M EN L EXPLIQUE	_
HUIT CHEMIN CAPBAT	LUI SE MONTRA CABOLET	_
OÙ VONT ELLES	COMMENT RETRAITE ELLE	_
IL LUTTAIT EN DEDANS	IL LUI LE VIT ET EN DE DORMIR	_
RENCONTREZ LES VOUS MÊME	RAPPORTS ONT CRÉÉ LES RÔLES	_
VOILÀ CE QU EST LA RESPONSABILITÉ	VOILÀ CE QUE LEUR RESTAIT LA RESPONSABILITÉ	_
CE SONT DEUX CHOSES DIFFÉRENTES	CE SONT DEUX CHOSES DE CHOSES DIFFICILES	_
L ORAGE A REDOUBLÉ	ARRÊTEZ UN RAPPEL AU RÈGLEMENT	_
ELLE CHANGEA DE COULEUR	ELLE S ENGAGEA DE COUVERTS DE CLAIRE	_
J AI FAILLI TOMBER MALADE	J AI FAIT TOUT À TOULON MALADE	_
SIX ALLÉE DU DOCTEUR ROYER	SI ÇA L EST DU DOCTEUR KERAOTRED	_
QUELLE PIÈTRE DÉFENSE	QUELLE PLAISIR VOTRE DÉFENSE	_
ET AUSSI DES AIGRIS	ET AUSSI DES AIGRIS	_
MONSIEUR LE MAIRE CE N EST PAS MOI	MONSIEUR LE MAIRE CE N EST PAS MOI CE N EST PAS MOI	_
VOILÀ QUI EST FAIT	VOILÀ QUI EST FAIT	_
ELLE A L AIR EN FORME	ELLE A L AIR EN FORMONS	_
RUE BONNAC À CLION	RUE BON BONNET À CLERMONT FERRAND	_
TOUT AUSSI GRAND	TOUTES DEUX S Y GRANDES	_
JE VOUS AI DEMANDÉ	JE VOUS AIME MON DOUDOU	_
MADAME EST ALLÉE À PARIS	MADAME DARDBERT À LA RÉPUBLIQUE	_
MOI J AI AIMÉ	MOI J AI AIMÉ	_
C EST EXACT	A T ELLE L AIR D AILLEURS	_
IL EST TEMPS D Y ALLER	IL EST TOMBÉ EN FAISANT	_
IL EST DE SUPPRESSION	IL EST DE SUPPRESSION	_
RUE DE SABEL BARJAC	RUE DE SABELLE BARRETAIRE AJACCIO	_
MAIS PARFOIS SUR LA COMPARAISON	MAIS PAS INFORMATION SUR LA COMPARAISON	_
C EST PAS JUSTE	C EST PAS JUSTE	_
JE NE VOIS RIEN	JE NE VOIS RIEN	_
JE SUIS GRUTIER	JE SUIS D ACTIVITÉ	_
LES PLUS CHERS	LES PLUS FERMÉS	_
C EST MIEUX COMME ÇA	C EST LUI COMMENCANT	_
J OUVRE LA BARRIÈRE TOUS LES MATINS	JE VOUDRAIS D ABORD À TOUS LES MATINS	_
T ES QUI	ET QUI	_
IL VA À L ÉCOLE	IL VA ALLER À L ÉCOLE	_
OH ÇA NE PRESSE PAS	OÙ SAVEZ LE PRESQUE PAS	_
JE NE ME SOUVIENS DE RIEN	JE ME SUIS BIEN D AILLEURS DORMIR	_
J AI UN SAC DE RIZ	J AI UN SAC DE RIZ	_
QUARANTE QUATRE FEMMES	QUARANTE QUATRE FEMMES FABLES	_
JE CROIS QUE L APPÉTIT EST TOUT À FAIT REVENU	JE CROIS QUE L APPLICATION DE PHÉNOMÈNE TOUT À FAIT REVENIR	_
CE N EST PAS CELA DU TOUT MON GÉNÉRAL	CE N EST PAS SÉRIEUSEMENT DU TOUT	_
À QUI DE FAIRE	AINSI QU IL DOIT FAIRE	_
QUAND VIENNENT ILS	QU EN VIENNE IL EST	_
COMMENT S APPELLE T ELLE	COMMENT S APPELLE VOTRE SŒUR	_
À QUI EST CE MANTEAU	À QUI EST CE MAINTENANT	_
C EST FATIGANT	C EST FATIGANTAN	_
TU ES SHEILA	TU ES CHER LÀLA	_
JOLI TALENT DE SOCIÉTÉ	JOHN EST LÀ S IL VOUS PLAIT	_
QU ELLE SOIT INDEMNISÉE	QUELLE SOIT INDEMNISÉ À DES MISÉS	_
HEIN EH BIEN ALORS PARLEZ MOINS HAUT	AINSI ÉNORMÉMENT À L EN PARLEMENTEMENT	_
CE NE SONT PAS DES JOUETS	CE NE SONT PAS DES JOURS	_
TOUTE RÉFORME FAIT DES PERDANTS	TOUTES CES RÉFORMATIONS ONT FAIT DES PERDREAUX	_
ÇA SE POURRAIT	ÇA SE PLAÎT À MOI	_
ON L AIMAIT MALGRÉ TOUT	ON L A ESSAYÉ MON REPRÉSENTATION	_
FEU DANS LA CHEMINÉE	FEU DANS DANS LA CHEMINÉE	_
VOILÀ QUI EST VRAI	VOULEZ VOUS L ACTIVEZ	_
IL NE FAIT QUE MANGER	IL NE FAIT QUE MANGER	_
JE M APPELLE RAJA	JE N APPELLE PAS L ARGUMENTATION	_
J AIME MON PAYS	J AIME MON PAYS	_
L AIDE DES POMPIERS	L AIDE DES POMPIERS	_
ON M A MIS TROIS JOURS D ARRÊT	OMER HÉRICOURT TROIS JOURS D ARRÊT	_
IL EST À LA MAISON	IL EST À LA MAISON	_
C EST TROP GRAND POUR MOI	C EST TROP GRAND POUR MOI	_
ÇA VOUS INTÉRESSE	ÇA VOUS INTÉRESSE	_
IL NE S AGIT PAS DE ÇA	IL NE S AGIT PAS DE ÇA	_
L ÉTOILE VÉGA	L ÉTOILE VÉGA	_
UN COMME ÇA	UN COMMISSAIRES	_
C EST UNE ZONE SÛRE	C EST UNE OBJECTIF	_
J ATTENDS MON TAILLEUR	J ATTENDS MON TERRITOIRE	_
HIER C ÉTAIT LA VEILLE	HIER C ÉTAIT LA VEILLE	_
VOILÀ VOTRE ORDRE	VOILÀ VOTRE HONNÊTE ENTRE	_
JE NE T ACCUSE DE RIEN DU TOUT	J AI ÉTÉ APPLAUDISSEMENTS SUR LES BANCS DU GROUPE REM	_
C EST TROP TARD	C EST TROP TARD	_
ON VA BIEN HAUT AINSI	ON VA BIEN AU AINSI	_
IL NE FAIT PAS BEAU AUJOURD HUI	IL NE FAIT PAS BEAU AUJOURD HUI	_
ELLES SONT EN TRAIN DE COURRIR	ELLES SONT EN TRAIN DE COURIR DE COURIERS	_
IL DEVRA ÊTRE QUELQUE PART	IL DEVRAIT ÊTRE QUELQUE PART À PARTIR	_
UN VERRE DE VIN	À BRAS DEUX VALETS	_
LES PLUS ANCIENNES	DES PLUS ANCIENNES ANNCIELLES	_
QUATRE RUE D ANNONAY	QUATRE RUE DE DAMEUX	_
LE LIVRE JAUNE	LE LIVROIS REJEIGNAIT	_
LA RÉPUBLIQUE DU PÉROU	LA RÉPUBLIQUE DOMINICAINE	_
C EST MA CONDITION	C EST MADEMOISELLE CLAIRE	_
J AI MON MÉDECIN	J AI MON MAÎTRESSE ÇA	_
QU EST CE QU IL A	QU EST CE QU IL EST LÀ	_
VOTRE PRÉNOM S IL VOUS PLAIT	VOTRE PRÉNOM S IL VOUS PLAIT	_
ATTENDEZ UN PETIT MOMENT TÉLÉPHONE	APPLAUDISSEMENTS SUR LES BANCS DU GROUPE UMP	_
SES PARENTS SONT SÉPARÉS	SES PARENTS SONT SÉPARÉS	_
POUR QUE NOUS PÊCHIONS	POUR QUE NOUS PÊCHIONS	_
DES POMMES DE TERRE EN ROBE DES CHAMPS	DEPUIS LE PÈRE DE TERRE EN ROANTE DE CHANTE	_
TU ES SÛR QUE NOUS AIMERONS	TU ES SÛR QUE NOUS AIMONS	_
MAINTENANT IL PÊCHE	MAINTENANT ELLES PÊCHENT	_
IL Y A DES MALADES PARMI ELLES	IL Y A DES MALADES LES MALADES PARMI ELLES	_
AH DIT LA JEUNE FEMME	AINSI DIT LA JEUNE FEMME	_
C EST ELLE	C EST ELLE	_
IL EST DEBOUT	IL EST DE LOI	_
C EST PASSIONNANT	C EST PASSÉ LÀ	_
EST CE QUE VOUS AVEZ OUVERT	EST CE QUE VOUS AVEZ OUVERT	_
IL SORT AVEC LE CHEVAL	IL SERA AVEC QUE LE CHEVAL	_
ELLE S EST RETIRÉE	ELLE S EST RETIRÉE	_
ÇÀ VIENNENT ILS NOS COMPAGNONS	ÇA ALLEZ CETTE OPINION DE COMPAGNON	_
ELLE N EST FONDÉE QUE SUR L AMOUR	ELLE EST FONDÉE QUELQUE CHOSE SUR LA NOURRITURE	_
L HOMME VIENDRA CE SOIR	L HOMME NOUS VIENDRA DE VENIR CE SOIR	_
IL EST CONTENT	IL EST CONTENT	_
LES CINQ GRANDES	DES SENSENCES DRÔLES	_
ELLE EST LÀ	ELLE EST LÀ	_
JE SOUTIENDRAI VOTRE TAILLE	JE SOUHAITERAIS VOTRE VENDRE VOTRE ÂGE	_
TRENTE ET UNE	TRENTE ET UNE	_
C EST ORIGINAL	C EST AU RÉGIME	_
QUELLE LANGUE PARLE T ON LÀ BAS	TU VIENDRAS QUAND TU VOUDRAS	_
ET LE CHAT	ET LE CHAT	_
RUE DE BOURBON LANCY À MONTCEAU LES MINES	RUE DE BOURRAN À CÉRÉMONT SUR L ÎLE	_
DONNEZ MOI L AUTRE	DE NOMBREUSES LETTRES	_
CA NE ME REGARDE PAS	ÇA NE ME REGARDE RIEN DE PAS	_
C EST ÇA TA SURPRISE PACAREL	C EST SIN A ASSEZ SURPRENANT QU ILS PATRIMOINE	_
VOUS ÊTES UNE FILLE VOUS	VOUS ÊTES UNE FILLE VOULUT	_
POUR QUOI FAIRE	POUR QUOI FAIRE	_
QUEL JOUR EST ON	QUE J AURAIS AIDÉ	_
NE FAITES PAS CELA	NE FAITES PAS ÇA LÀ	_
ÇA NE PEUT PAS ÊTRE TOUT	ÇA NE PEUT PAS ÉCRIT TOUCHÉ	_
PORTE T IL UN BONNET DE COTON	POUR QU IL A BOLEVÉ L ANGLAIS DE CÔTÉ	_
ANNETTE SE RENVERSA AU FOND DE LA VOITURE	ALLONS MES CHERS COLLÈGUES ONT ARRÊTÉ ON LA VOITURE	_
IL ARRIVA LE SOIR DU TRENTE ET UN DÉCEMBRE	IL AVAIT VU LE SOLEIL DU TRANSPORT DU CROTTEUR DES SYNDICATS	_
VOILÀ MON NUMÉRO	VOILÀ MON IMMOINS	_
ILS ONT ÉTÉ AIMÉ	ILS ONT ÉTÉ AIMÉS	_
TROIS VILLAGE DE LAFONTASSE	TROIS LIVRES DE LA FENÊTRE	_
POUR QU IL PÊCHE	POUR QU ILS PÊCHENT	_
UN PAUVRE IMBÉCILE	COMPRENDRE EN DEHORS UN DE SUITE	_
EST CE TOUT MONSIEUR	EST CE TOU MONSIEUR MONSIEUR	_
LES CHOSES QUE JE N AIME PLUS	LES CHOSES QUE JE N AIME PLUS	_
QUAND L AVIEZ VOUS VUE EN DERNIER	COMMENT ALLEZ VOUS VOUS ÊTES VOUS EN DORMIR	_
JE SUIS SÛR QUE J AIMERAI	JE SUIS SUR QUE J AIMERAIS	_
C ÉTAIT TOI BERNARD	C EST TON TOUR	_
ICI AU MILIEU DE CETTE FOULE	IL Y ÉTUDIE À L UNIVERSITÉ FROID	_
IL ENTRE À DROITE	IL ENTRE À DROITE	_
IL VA PLEUVOIR AUJOURD HUI VOUS PENSEZ	IL VA PLEUVOIR AUJOURD HUI VOUS PENSEZ	_
C EST FERMÉ LE DIMANCHE	C EST SERVICE DE L ÉDUCATION	_
TRENTE DEUX RUE VIETTE	TRENTE DEUX RUE LOUIS VICT	_
TOUS SAUF UN	TOUS SE SAVAIENT CE FUT PAS	_
DITES MOI S IL VOUS PLAIT	HISTOIRE À SES BOUCLES	_
IL Y A DES RICHES À ETEL	IL ALLA LES RICHES LA TÊTE	_
C EST TOI QUI L A	C EST POSSIBLE LÀ	_
INVITÉS DES DEUX SEXES	AVIS DÉFAVORABLE DE CET EFFET	_
QU AVEZ VOUS DONC	QU AVEZ VOUS DONC	_
ELLE SERA AVEC NOUS DEMAIN	ELLES SE RARAIENT AVEC NOUS DEMAINS DEMAIN	_
ET J ACHÈVERAI MON DEVOIR	ET LA CHÈRE RÉPONDIT MON DEVOIR	_
C EST UNE BELLE COUPE DE FILLE	C EST UNE BELLE CÔTE DE COUPS DE FILLES	_
FAITES COMME JE VOUS DIS	FAITES COMME JE VOUS EN DOUTE	_
IL EN A BESOIN	IL EN A BESOIN DE VOUS	_
TU NE MANGES PAS ASSEZ	TU NE M ENNUIES PAS ASSEZ	_
AVEC QUOI VOUS DIVERTISSEZ VOUS	AVEC COLLÈGUE COMPLÈTEMENT VICTORIEUX	_
LA MAISON EST JOLIE	LA MAISON EST JOLIE ET JOLI	_
C EST DÉJÀ MIEUX	CE DÉJEUNER	_
OUI DANS UNE CERTAINE MESURE	OUI DANS UNE CHARTE EUROPÉENNE DES LANGUES	_
NOUS LA VOTERONS	NOUS LE VOULONS TENDRE	_
LE REFUS DE L IMPÔT	LES RE FAITS DES GENS PAUVRES	_
IL LE FAUT ABSOLUMENT	IL LE FAUT ABSOLUMENT À CELUI LÀ	_
DIX NEUF RUE EUGÈNE NICOT	DIX NEUF RUE AUGUSTE NICOT	_
ÇA C EST MARRANT	ÇA C EST MARRANT	_
IL N EST PAS ICI POUR LE MOMENT	IL NE PEUT PAS RESTER PLUS LONGTEMPS	_
RUE RUFFI NÎMES	RUE RENÉ FISCHINE	_
AVANT LES TROIS DERNIERS	AVANT LES TROIS DERNIERS	_
ALLONS À L ESSENTIEL	À L ENSEMBLE DES SENTIMENTS	_
JE N AI PAS LE TEMPS DE VOUS VOIR	JE N AI PAS LE TEMPS DE VOUS VOIR	_
QUI EST CET HOMME LÀ BAS	QUI EST CETTE HEURE LÀ BAS	_
DE SA FAUTE	DE SA FAUTE	_
JE N AI PU LES SUIVRE QUE DE LOIN	JE N AI PLUS DE SUIVRE QUE DE LOI	_
À QUELLE HEURE OUVRE LA BANQUE	A QUELLE HEURE OUVRIRA LA BANQUE	_
IL COURUT À LA POSTE	ILS COURURENT À LA POSTE	_
JE NE SAIS RIEN	JE LE SAIS RIEN	_
C EST UNE CRÈME	C EST UNE TRÈS LONG TRAVAILLE	_
IL Y A DEUX HEURES DE ROUTE EN VOITURE	IL Y A DEUX HEURES DE RETROUVER DANS VOTRE OPINION	_
VOUS LE SAVEZ BIEN	VOUS VOUS NE SAVEZ BIEN	_
VOILÀ QUI EST BIEN	VOILÀ QU IL EÛT AIMÉ	_
IL Y A	IL Y A LÀ	_
ELLES ELLES AIMERONT	ELLES ELLES AIMAIENT	_
UN JEUNE HOMME POUR ELLE	À GENDARMES TOMBERALLES	_
IL A SON PANTALON	IL LAISSAIT SON PAUVRE PÈRE TELLEMENT	_
ELLE REGARDE EN TRAVERSANT	ELLE REGARDAIT DANS LA TRANSITION	_
IL Y EN AURA	IL Y EN AURA	_
LA PRIEURE CONTINUA	LA PRIEURE CONTINUERA T IL	_
C EST RESPECTUEUX DE L ENVIRONNEMENT	C EST INSPECTUEUX LES AMENDEMENTS IDENTIQUES	_
TIENS J AI FAIM	TIENS J AI FAIT	_
RUE CAZAUD AURILLAC	RUE CASQUE ANGOULÊME	_
JE M APPELLE FULUP	JE M APPELLE FULUP	_
OÙ EST ELLE	OÙ EST ELLE	_
IL EST CAPABLE OUI OU NON	IL EST CAPABLE DE POIGNONS	_
ON LES HUA	OÙ L EST IL LÀ	_
CELA NE TIENT PAS LA ROUTE	CELA NE TARDERA PAS LA RUSE	_
IL JOUAIT AVEC MOI	IL JOUAIT AVEC TOI	_
TIENS C EST TRÈS MALIN	TIENS C EST TRÈS MAL	_
ELLE EST LÀ BAS	ELLE EST JAMBE	_
QUAND PARTONS NOUS	QUANT À PART TELLEMENT	_
MAIS ÇA N A PAS ÉTÉ LONG	MAIS CE NE SONT PAS INTÉRESSANTES LÀ	_
LA PAGE QUARANTE QUATRE	LA RÉPUBLIQUE DOMINICAINE	_
QU IL SENT BON MON DIEU	QU IL S EN BON DANS MON LIEUTENANT	_
OUI VOTEZ LE	OUI J AURAIS AIDÉ LÀ	_
SQUARE DU PRÉSIDENT KENNEDY AU NUMÉRO QUATRE	SQUARE DU PRÉSIDENT THOMASTIGNY AU NUMÉRO QUATRE	_
MERSI DE TES RÉPONSES	MERCI DE TA RÉPONSE	_
ELLE EST JOLIMENT LOURDE	ELLE EST JOLIE À L HÔTEL MARIOTT	_
TU ES SÛR QU ELLES AIMÈRENT	TU ES SÛR QU ELLES AIMÈRENT	_
EH BIEN ACCROCHE LA	EH BIEN À APPRENDRE LA PREMIÈRE FOIS	_
J AI FAIT QUELQUES ÉCONOMIES	J AI FAIT QUELQUES EXEMPLES	_
LE PLUS POSSIBLE	LE PLUS PRIS POSSIBLE	_
NON JE SUIS LÀ	NON JE SUIS LÀ	_
NE VIENS PAS ICI	NE VIENS PAS ICI	_
NE CRAIGNEZ RIEN POUR MA SANTÉ	NE CRAIGNANT PAS RIEN POUR MA SENTIMENT POUR MA SANTER	_
IL TRÉPIGNE D IMPATIENCE	IL TRÉPIGNAIT PAYER LES DANDESCIERS	_
JE N AVAIS PAS DÉJEUNÉ	JE N AVAIS PASIX DÉJEUNER	_
C EST TRÈS AMUSANT	C EST TRÈS AIMABLE	_
POUVEZ VOUS M AIDER	POUVEZ VOUS M AIDER	_
IL VENAIT SOUVENT ME VOIR	ELLES FURENT AUSSITÔT ARROGANTES	_
NOUS PENSONS DE MÊME	LES PENSIONNAIRES SONT DE MÊMEIL	_
À QUELLE HEURE VIENT ELLE	QUEL EST L HEURE DU DÎNER	_
C EST BIEN VU	C EST BIEN VIEUX	_
IL EST PARTI	IL EST PARTI	_
C ÉTAIT CHER	C ÉTAIT CHER	_
QUARANTE SEPT RUE EDMOND MILLE	QUARANTE SEPT RUE HUGOIGNY	_
YANN N AVAIT PAS OUVERT LA LETTRE	YANN N AVAIT PAS OUVERT LA LETTRE	_
MOI AUSSI JE M Y PERDS UN PEU	MOI AUSSI JE LUI PERDS D ARGENT	_
MAIS L ENFANT VA MOURIR	MÊME L ENFER À NOUVEAU À MON RIRE	_
ILS ARRIVÈRENT EN MÊME TEMPS	ILS ARRIVRIAIENT EN MÊME TEMPS	_
JE VOUS PRENAIS POUR UN OURS GRIS	JE VOUS PRIE DE PROGRESSER À NOUVEAU CE DÉBAT	_
ELLE S EN EST TIRÉE	ELLE S EN EST TIRÉE	_
QU IL EST BÊTE	QU IL EST BÊTE	_
JE L AIME ENCORE	JE L AI AIME MON CŒUR	_
NE BOUGEZ PAS	NE BOUGEZ PAS	_
VOUS NE LE SAVIEZ PAS	VOUS LE SAVEZ PAS	_
IL VA LE TUER ROXANE	IL EST ABSOLUMENT IMPOSSIBLE	_
ON NE PEUT PAS DIRE ÇA	ON NE PEUT PAS DIRE DIRE ÇA	_
PUIS IL APPELA GAVROCHE	SUITE L APPLAUDISSEMENTS SUR LES BANCS DU GROUPE SRC	_
VINGT QUATRE HEURES	ELLE AIME TA SŒUR	_
IL N EST PAS AVEC VOUS	IL N EST PAS UNE VOLONTÉ	_
ÇA C EST ÊTRE CONNU	ÇA C EST TRÈS COMMUNIQUER	_
C EST DÉJÀ FAIT	C EST DÉJÀ FAIT	_
ELLE NE RÉPONDIT PAS	ELLES NE L AVAIENT PAS ÉCOUTÉE	_
IL NEIGE OÙ PAS	IL N AJOUTAIT PAS	_
AH C EST UNE RAISON	AH C EST QU IL RIGOLEE	_
QUE DIABLE VOULEZ VOUS	TU AS BIEN BESOIN DE VOUS LES VOIR	_
C EST CELUI LÀ QUE J AIME LE MOINS	C EST CELUI LÀ QUE J AIME LE MOINS	_
ET JE VIS L AVION PARTIR	ILS VEULENT L HABITUDE AUX PARTIES	_
MAIS LE PROBLÈME EST MAJEUR	MAIS LE PROBLÈME PROMÈNE EST MAJEURE LE MAJOR	_
JE N AI PAS ASSEZ D ARGENT	JE N AI PAS ASSEZ D ARGENT	_
SEPT CENT TRENTE QUATRE SEQ	SEPT CENT TRENTE QUATRE CÔTEAUX	_
IL EST DONC TEMPS D AGIR	IL EST DONC IMPORTANT D AIGUILLER	_
D OÙ EST IL	D OÙ EST IL	_
L AMOUR DU PROCHAIN	LA MOURANTE DE PAUVRES CHIENS	_
JE DÉSIRE NE PAS QUITTER MADAME	JE DÉSIGRE LE PATRIMOINE LINGUISME	_
DANS TA CHAMBRE	DANS TA CHAMBRE	_
JE M APPELLE RAJA	JE M APPELLE ROGER RAJOUT	_
ET ELLE VOUS ATTEND CE SOIR	ET ELLE ROUGISSAIT LE VOISIN CE SOIR	_
IL N Y EN A PAS	IL N EN N A PAS	_
IL FAUT TROUVER UNE SOLUTION	IL FAUT TROUVER UNE EXEMPLE EXCESSION	_
JE REGRETTE JE TRAVAILLE	JE REGARDERAI JE DOIS RÊVE	_
VOUS N AVEZ PAS MANGÉ ENSEMBLE	VOUS N AVEZ PAS MAL À MANGER ENSEMBLE	_
VINGT DEUX MAISONS	VINGT DEUX MAISONS	_
C EST CE QUE NOUS SOUHAITONS	C EST CE QUE NOUS SOUHAITONS APPRENDRE	_
VOUS ÊTES QUI	VOUS ÊTES QUITILLIT	_
C EST UN VRAI PROBLÈME	C EST UN VRAI GROS PROBLÈME	_
OÙ TRAVAILLE T IL MAINTENANT	VOTRE AMENDEMENT EST IL MAINTENANT	_
J AI DE LA FIÈVRE	J AI DE LA FIÈVRE	_
SE DEMANDAIT IL À NOUVEAU	CE DERNIER MOT BLESSAILLIT À L HÔTEL	_
AH C EST MON ONCLE TOUPART	AH C EST MON MON PEUT QUE TU PART	_
NOS PROPOSITIONS IRONT DANS CE SENS	LE PROPOSITIONS AMENDEMENTS IDENTIQUES DANS SES SENSANCES	_
LE MOULE EN EST BRISÉ	LE NOUVEAU L ENNE TRISTAIT	_
QUI SONT ILS	QUI SONT TIERS	_
C EST DU CAPORALISME	C EST LUI CRAIGNIT QU UN PAUVRE HISTOIRE	_
DANS L ARMOIRE	DANS L ARMOIRE	_
LE PREMIER MAI	LE PREMIER NIVEAU	_
ENTRE CHAIR ET CUIR	ENTREPRENDS C EST À ÉCRIRE	_
ELLE VOYAIT SON FILS SAUVÉ	ELLE VOYAIT S ENFUIRENT FIER SAUVER	_
JE ME VOYAIS DANS L EAU	JE ME VOYAIS DANS L EAU	_
VIENS VOIR UN PEU SI ÇA MARCHE	DIEU VOUS REMERCIE MONSIEUR LE SECRÉTAIRE D ÉTU	_
DIEU VOUS BÉNISSE	DIEU VOUS BÉNISSE	_
VOUS POUVEZ REDIRE ÇA S IL VOUS PLAIT	VOUS POUVEZ PARLER DIT FORT S IL VOUS PLAIT	_
UN PETIT CHIEN	APPLAUDISSEURS	_
DANS QUEL TEMPS SOMMES NOUS	QUANT ELLE TENDIT DANS CELUI LÀ	_
LE DENTISTE S IL VOUS PLAÎT	LE TEMPS EST FROID S É VOUS PLAÎT	_
IL EST INTERDIT D ENTRER	IL EST INTERDIT DE TERRE D ENTRÉE	_
L HEURE DU DÎNER	L HEURE DU DÎNER	_
ASSUMEZ VOS CHOIX	ASSUMEZ VOS CHOUXS	_
QU AVEZ VOUS OUVERT	QU AVEZ VOUS OUVERT	_
ON N A PAS ÉTÉ DÉÇUS	ON N A PAS ÉTÉ BESOIN DE DESSUS	_
RÉPARTISSONS LES CHOSES	APPLAUDISSEMENTS SUR LES BANCS DU GROUPE SRC LES CHOSES	_
JE SUIS À LA FENÊTRE	JE SUIS À L ASSEMBLÉE	_
TU ES SÛR QU IL AIME	MONSIEUR C EST QU IL RIGOLE	_
NON C EST LA PREMIÈRE FOIS	NON C EST LA PREMIÈRE FOIS	_
C EST TRÈS DISCUTABLE	SES TRAITS TRANQUILLES DISPUTÉES	_
J AIME L ANGLAIS	J AIME L ANGLAIS	_
TU ES PARENT AVEC M MOHAN	CE N EST PAS ARRÊTÉ MONSIEUR LE PRÉSIDENT	_
ELLE AIMERAIT TA SŒUR	ELLE AIMERA TA SŒUR	_
DONNONS LUI DE L OCCUPATION	DEUX LONGS LUI VILS DE L OCCUPATION	_
QUE LE TEMPS EST BEAU DANS TON PAYS	QUE LE TEMPS EST BEAU DANS D AUTRES PAYS	_
C EST SON LIVRE	CE SONT LES LIVRES	_
À QUELLE ÉCOLE VA T IL	A QUELLE HEURE VIENT ELLE VA ICI	_
MAIS NE VOUS EN INQUIÉTEZ PAS	NE NE VOUS INQUIÉTEZ PAS	_
N Y VA PLUS	N Y A PLUS	_
NOUS N AVONS JAMAIS DIT CELA	NOUS N AVONS PAS BESOIN DE DIX CELAS	_
QUATRE JEUX INTÉRESSANTS	QUATRE JEUX JEUX INTÉRESSANTS	_
DEMAIN TU PÊCHERAS	DEMAIN TU PÊCHERAS	_
IL PRENAIT SON CHAPEAU	IL FALLAIT PRENDRE SON CAFÉ AU LAIT	_
LES CONSTELLATIONS SONT BRILLANTES	LES CONSEILS D ASSIETTES SANS BRILLANTES	_
VOUS ME FUYEZ DIT IL	DANS MES FUSILS JUSQU ICI	_
MAIS ÇA L EST	LES SCÈNES	_
DOUZE BIS RUE SAINT MALO	DOUZE BIS RUE SARK VALLOT	_
QU EST CE QUE VOUS FAITES LÀ POURQUOI TREMBLEZ VOUS	QU EST CE QUE VOUS FAITES LÀ POUR ABANDONNÉ	_
LUI INDIQUANT LA CAISSE	LUI IL A DIT POUR LA CAUSE	_
RIEN NE LE PROUVE	QUEL EST L AVIS DE LA COMMISSION	_
LE COMTE S ÉTAIT LEVÉ	LE COMTE S ÉTAIT LEVÉ	_
QUAND ALLEZ VOUS	QUANT À LA VÉRITÉ	_
QU ÉTAIS TU EN TRAIN DE FAIRE	QU ÉTAIS TU EN TRAIN DE FAIRE DE FAIRE	_
VIENS AVEC NOUS	BIEN AVEC NOUS	_
TU AS PEUR D EUX	TU AS PEUR DE VOUS DONNER	_
LA PRIEURE SONGEAIT	LA PREMIÈRE TIENNE SONGEAIT	_
YANN TRAVERSA LA MER	BIEN NOUS TRAVERSER LA NOURRITURE	_
DEMANDA T IL	DE MOINS D ACTIVITÉ	_
IL PLIA LE BOUT DE PAPIER ET LE MIT DANS SA POCHE	IL CLIGNOLA LE BOUT DE PAPIER ET LE NOUVEAU COUPÉ DE NOUVEAU SA POPULATION	_
C EST TON AVIS	C EST TON AVIS	_
AU GÉNÉRAL JOUBERT	AU GÉNÉRATION EST JOUÉ	_
OÙ C EST	OÙ SEUL	_
LA LIBELLULE A DEUX PAIRES D AILES	LA RÉPUBLIQUE DOMINICAINE	_
LAISSONS CET IMBÉCILE DE CÔTÉ	L ESSENCE EST DE RÉSIDENCE DANS LES DOCUMENTS	_
LES TÉNÈBRES SONT L HABITUDE	LES ÉTABLISSEMENTS DOIVENT ÊTRE SONT LA BIBLIOTHÈQUES	_
VOUS AVEZ QUELQUE CHOSE	VOUS AVEZ QUELQUE CHOSE	_
LA PROCHAINE FOIS	LA PREMIÈRE PREMIÈRE FOIS	_
JE SUIS DIPLOMÉ DE B E	JE SUIS DIPLÔMÉ DE BLÉMETTES DE BÉE	_
JE VAIS À TABLE	QU EST CE QUE JE DEVRAIS ATTENDRE	_
A LA BONNE HEURE	À LA BONNE HEURE	_
SEPT RUE DE LA MARTINELLE	SEPT RUE DE LA MARTHLLEINE	_
C EST CELLE LÀ LA TIENNE	C EST CELLE LÀ LA TIENNE LA TIENNE	_
L EXCRÉMENT RÊVE DE JUDITH	EXCLAMATIONS SUR LES BANCS DU GROUPE	_
JE PUIS FAIRE DU BRUIT	JE PLUS FER DE NOUVEAU	_
IL SERAIT TEMPS	IL SERAIT TEMPS	_
VOUS POUVEZ PARLER DOUCEMENT	VOUS POUVEZ PARLER DE SOUS AMENDEMENTS	_
PUISQU ILS SONT PAYÉS	PUISQUE C EST QU IL S EN PAIEAIT	_
JE NE SAISIS PAS BIEN	JE NE SAIS CE SYSTÈME	_
J AI CRU QUE JE NE TE REVERRAIS PLUS	J AI CRU QUE J AIMERAIS QUE JE NE DE REGARDERAI PLUS	_
C EST QUELLE ADRESSE	C EST QU ELLE A DRESSÉE	_
C EST TRÈS AGRÉABLE	C EST TRÈS AIMABLE	_
NOUS POUVONS ENTENDRE TOUS LES ARGUMENTS	NOUS POUVONS DONC ENTENDRE TOUT À TOUS LES ARGUMENTS	_
VOULEZ VOUS UNE TABLE	VOUS LES VOULEZ VOUS DONNER	_
LA MARQUISE POURRA ME PARLER SANS CRAINTE	LA MARQUISE ENTRANT PAR LE PARLER SANS CRAINTE	_
MOI J ÉTAIS TROP FATIGUÉ	MOI J ÉTAIS TROP FATIGUÉ	_
TROIS CENT SOIXANTE ET ONZE	TROIS CENT SOIXANTE ET ONZE ONZE	_
C EST MA PETITE SŒUR	C EST MA PETITE SŒUR	_
QU EST CE QUE C EST	QU EST CE QUE C EST	_
DE TOI JE PLAISANTAIS	D AUTRES MOIS JE PLAISANTAIS	_
DONNEZ LE LEUR	DEUX ÉLÉPHANTS NOIRS	_
CERTES SI VOUS RESTEZ LÀ	TIENS C EST VRAI S IL VOUS PLAÎT LÀ	_
VOUS CONNAISSEZ PARFAITEMENT LES LIEUX	VOUS NE CONNAISSEZ PAS CETTE PARTIE OÙ L ÉDUCATION	_
ON NE SAIT FIT BRIENNE	EN EFFET MONSIEUR CRIPRIEN	_
J Y AI RÉUSSI JUSQU À PRÉSENT	J IRAI RIRE À RÉUSSI JUSQU À PRÉSENT	_
LE PLUS ANCIEN	PLUSZ ÇA S IL VOUS PLAIT	_
MAIS REGARDE MOI DONC	MAIS LES REGARDS MADAME MONTAUDOIN	_
JE LES IGNORAIS	JE LES IGNORERAI	_
S IL VOUS PLAÎT	S IL VOUS PLAIT	_
DANS TON VIN	DANS TON VIN	_
LA PLUIE AVAIT CESSÉ	À PLUIE À L EXPÉRIMENTATION	_
TOUS HOCHAIENT LA TÊTE	TOUS AUCHAIENT LA TÊTE	_
MAIS NOUS AVIONS LE TEMPS	MAIS NOUS AVIONS LE TEMPS	_
ELLE VA À SA TOILETTE	ELLE VA À SA TOILETTE À SA TOILETTE	_
TU ES SÛR QUE TU AIMAIS	TU ES SÛR QUE TU AIMAIS	_
MERCI BEAUCOUP À VOUS	MERCI BEAUCOUP DE COHÉRENCE	_
IL AVAIT TOUT POUR LUI CELUI LA	IL AVAIT TOUT PAULINE CELUI LÀ CELUI LÀ	_
VOUS AVEZ ASSEZ D ARGENT SUR VOUS	VOUS AVEZ ASSEZ D ARGENT SUR VOUS	_
MON SAC EST LOURD	ON S INQUIÈTE ÉNORME	_
JE PARLAIS À L INSTANT DE FIERTÉ	JE PARLAIS L ANGLAIS À L INSTANT DE FICHIER	_
VINGT CINQ ANIMAUX	VINGT CINQ ANIMAUX	_
N IMPORTE QUOI	N IMPORTE QUOI CE POINT	_
C EST LÀ BAS	C EST LÀ BAS	_
VOUS ÊTES SI BONNE POUR MOI	PEUT ÊTRE QU IL A GRANDI PENDANT LA NUIT	_
CET ENDROIT ME PLAIT	C EST TON TOUR DE LA PLANTE	_
ELLE ÉTAIT TROP ÉPOUVANTÉE	ELLE NE PEUT TRAÎNER PAS PAUVRE PÈRE UBU	_
SIX RUE BRÈVE	SI ELLE VEUT ET BÈRES	_
QU ENTEND ON	COMMENT PAUVRE TEMPS	_
C EST LES VACANCES	CE N EST LA CONNAISSANCE	_
ELLE EST CHAUDE	ELLE EST CHAUDE	_
BONNE ANNÉE À VOUS	BONNE ANNÉE À VOUS	_
CAR JE LE CROIS TRÈS MALHEUREUX	QUARTIER LE CROITR TREIZE À LA RÈGLE	_
EST CE QU IL VIENDRA	EST CE QU IL VIENDRA	_
RUE JEAN GIRARD BOURGES	RUE JOSEPH GÉRARD BOGES	_
IL EST PARTI	IL EST PARTI	_
IL DOIT COMPRENDRE	IL DOIT COMPRENDRE	_
C EST DIX SEPT DOLLARS	C EST DIFFICILE DE L ORDRE	_
IL A COMMENCÉ PAR RÉCLAMER UNE VOITURE	IL A COMMENCÉ À COMMENCER PAR RÉCLAMATION LONGTEMPS	_
MILLE TONNERRES JE N Y TENAIS PLUS	LUNDI DE PÂQUES JE LUTTAI CONTRE LES PLUSLUS	_
VOYONS TU PERDS LA TÊTE	VOYONS TU PERDRE LE TÊTE	_
QUE DIABLE ÊTES VOUS EN TRAIN DE FAIRE ICI	QUE DIEU MERCI DE VOTRE RÉFLEXION	_
CE DONT JE DOUTE FORT	C EST TON TOUR DE MON COUSIN	_
LA PAROLE EST À MONSIEUR THIERRY MANDON	LA PAROLE EST À MONSIEUR PHILIPPE NAILLET	_
VOUS AVEZ UNE AMOUREUSE	VOUS AVEZ UNE AMOUREUSE	_
COMBIEN Y A T IL D HABITANTS À NEW YORK	COMBIEN Y A T IL D HONNEUR À L OCCASION	_
À L ABBAYE DU RELECQ	À L ABBAYE DU RELECQ	_
ENTRE SEPT ET HUIT HEURES LE MÉDECIN VINT	ON S INQUIÈTE É LUICTEUR À LES MÉDICAMENTS	_
ALORS VOTEZ LE	ALORS VOTEZ LE	_
QU EST CE QUI SE PASSE	QU EST CE QUI S EST PASSÉ	_
JE NE VOUS EN PRIVERAI PAS LONGTEMPS	JE NE VOUS EN COMPRENDS PLUS LA RÉPUBLIQUE	_
QUI C EST	QU EST CE QU IL FAIT	_
IL FAUT TRANCHER DANS LE VIF	IL FAUT TRAÎNER TRANSCER DANS LE LIF	_
JE DOIS LAVER MES VÊTEMENTS	JE DOIS LA VÉRITÉ L UTILISATION	_
OÙ L AVEZ VOUS MIS	OÙ L AVEZ VOUS MIS	_
IL EST ASSEZ GRAND	IL EST AINSI D GRANDS	_
IL PRÉFÈRE PARTIR	IL PRÉFÈRE FAIRE PARTIR	_
EST TRÈS INTÉRESSANTE	ET TRÈS CONCRÈTEMENT LES FENÊTRES	_
QUATRE IMPASSE DES HAMEAUX	QUATRE PASSAGE DES ANNEAUX	_
RUE DE LOULANS À MONTBOZON	RUE DE WOLLOSHEIM À MONTAUBAN	_
MALHEUREUX SAIS TU CE QUE C EST QUE LE GUANO	MALHEUREUSEMENT C EST TU S OCCUPER CE QUE LE VOISIN	_
TOI AUSSI T AS DÉCIDÉ DE ME FAIRE CHIER	TOUT AUSSI DANS MES IDÉES QU IL ME FERCHÉ	_
SIX BOULEVARD DE FRIEDBERG	S IL VOULAIT L ARGUMENT DE FRUITS	_
IN 8 NE SONT QUE DEUX STROPHES DE NAMOUNA	IL LUI NE SONT QUE LE SOLEIL DE FRANCE DEMAIN	_
TOUT À FAIT DIS JE	TOUT À FAIT DIT DIEU	_
COMBIEN LE TOUT	COMBIEN DE TEMPS ALLEZ TOUT	_
CE N EST PAS VRAI N EXAGÉREZ PAS	CE N EST PAS VRAI VOUS NE NOUS AJOUTEZ PAS	_
LES OBJETS NOUS POSSÈDENT	LES OBJETS GRAVES LE POSSÉDAIENT	_
LE JOUR ÉTAIT LONG ET LE TEMPS BEAU	JOHN EST LÀ S IL VOUS PLAIT	_
ELLE FAIT MINE DE REMONTER	ELLE VENAIT MINUIT DE REVENIR DES REMARQUES	_
QUEL ÂGE AVEZ VOUS	QUEL EST L AVIS DU GOUVERNEMENT	_
COMBIEN DE CHAMBRES Y A T IL DANS LA MAISON	COMBIEN DE CHARLES DE CHAMBRE A T IL DANS LA MAISON	_
CE N EST PLUS DE NOTRE ÉPOQUE	CE N EST PLUS MADEMOISELLE CLAIRE	_
SON CORPS N EST PAS LÀ	SANS CORRESPONDÉS N EST PAS LÀ	_
J AI DEUX FRÈRES ET UNE SŒUR	J AI DEUX FRÈRES ET UNE SŒUR	_
IL EST ICI	IL EST NÉCESSAIRE	_
UN PANTALON BEAUCOUP TROP SERRÉ	UN PANTALON BEAUCOUP TROP TROP SERRÉ	_
D OÙ VIENS TU	DEUX VERRES TYPES	_
QUAND CELA SERA T IL PRÊT	QUAND SOLDATS CELA SERA T IL PRÊTE PRÊT	_
C EST PLUS RÉCENT	C EST PLUS RESPECTANT	_
DE QUELLE VILLE ÊTES VOUS	MAINTENANT ELLES PÊCHENT	_
C EST MOUILLÉ	C EST MOUILLÉ	_
JE N AI PAS DE PETIT AMI	JE N AI PAS DE PAQUET DE PETITT ANNÉE	_
ELLE HABITE À RENNES	ELLE HABITE À RENNES	_
VOUS EN AUREZ D AUTRES	VOUS EN AUREZ D AUTRES	_
JE RECONNAIS ÇA À LA SONNETTE	J AI RECONNU SA LEÇON ET LA SÉNATTE	_
LE PEUPLE AIME LES FÊTES	LE PEUPLE ALLAIT ALLAIT LA FÊTE	_
QU EST CE QUE C EST QUE CES MANIÈRES	QU EST CE QUE C EST QUE CE MAGASIN	_
C EST RASSURANT	C EST RASSURANT	_
JE ME RÉJOUIS DE CE DÉBAT UTILE	JE ME RÉJOUIS DE CE DÉBAT	_
DEMAIN ILS PÊCHERONT	DEMAIN IL PÊCHERA	_
C EST VRAI MAIS IL FAIT SI CHAUD DEPUIS UN MOIS	C EST VRAI MAIS ILS FACICHENT DEPUIS UN MOIS DE PIARD MOI	_
ON M A DIT QU IL Y AVAIT UN DENTISTE DANS CETTE RUE	ON A DIT QU IL Y AVAIT UN VERRE D EAU S IL VOUS PLAÎT DANS SES TRÊPES	_
TOUT EN FINESSE	TOUTES LES FIGURES FINALES	_
NOTEZ PAR ÉCRIT S IL VOUS PLAIT	NOTEZ PAR L EFFICACITÉ C EST VOUS CLAIREAUX	_
JE LIS LE TIMES	JE LIS LE TÉLÉPHONE	_
LA CHAISE EST CASSÉ	LA CHAISE EST CASSÉE	_
LE TEMPS PASSÉ	LES T ELLES QU ELLES PASSAIENT	_
ON EST À L ORDRE	LUI ALLEZ À L AUTRE	_
VOUS VOUS AIMEZ	VOUS VOUS AIMIEZ	_
C EST POURQUOI	C EST POURQUOI	_
JE L AI VU	JE L AI DIT	_
C EST LUI QUE J AIME LE PLUS	C EST LUI QUE J AIME LE PLUS	_
C EST COMPLÈTEMENT DÉBILE	C EST COMPLÈTEMENT DÉBUT	_
HIER ELLE PÊCHAIT	KIRSCHBAUM EST PÉCUCHET	_
AU PROFIT DES GRECS	AU TROIS FILS DES GRETTES DES GRÈQUES	_
JE N EN SAIS RIEN	JE N EN SAIS RIEN	_
D AUTRES ANIMAUX JAUNES	D AUTRES ANIMAUX JAUNES MAJEURES	_
JE SUIS EXTRÈMEMENT SATISTFAIT	JE SUIS EXTRÊMEMENT SATISFAIT	_
UN DÉCRET POURRAIT EN PRÉCISER LA DÉFINITION	LA DÉTERRRÉE POUVAIT EN PRÉCISER LA DÉFINITION	_
NE LUI OUVREZ PAS LA BOUCHE DE TOUT CELA	NE LUI OUVRIREZ PAS LA BEAU DE POSSIBILITÉ DE TOUS CELA	_
IL EST LÀ	IL EST LÀ	_
ET ELLE VIENDRA	ET IL VIENDRA	_
LEQUEL EST VOTRE SAC	LE CA EST VOTRE OFFICE	_
QU EST CE QUE TU PENSES	QU EST CE QUE TU PENSES	_
LE COMBIEN SOMMES NOUS	LE COMMISSAIRE LONG	_
LES HOMMES NE VALENT RIEN	LES HOMMES NE VEULENT RIEN	_
IL Y A LÀ UN MONSIEUR QUI ARRIVE DE BORDEAUX	QUEL EST L AVIS DE LA COMMISSION SUR CES AMENDEMENTS IDENTIQUES	_
L AFFAIRE SERA CHAUDE	LA FEREUR SERA CHAUD	_
CAMI DES OEILLADES AU NUMÉRO UN	QUEL EST L AVIS DE DEUX AMENDEMENTS IDENTIQUES	_
QU EST CE QU ILS ÉTUDIENT	QU EST CE QU IL EST AINSI	_
EH BIEN ET MOI	AI BIEN ET MAINTENANT	_
QUAND ARRIVEZ VOUS AUX USA	QUEL EST L AVIS DE LA COMMISSION SUR CES AMENDEMENTS FAVORABLES	_
ILS N EN PEUVENT PLUS	IL N EMPÊCHE QUE FRUITS	_
C EST CERTAIN	C EST CERTAIN	_
IL FAUT ALLER PLUS LOIN	IL FAUT ALLER ALLER PLUS LOIN	_
RUE DE MONTJOIE GOUDELIN	RUE DE MONTANGES À BOUGUELAN	_
IL EN FAISAIT UN ÉLOGE ENTHOUSIASTE	IL EN PRÉSENTAIT L ÉLÈVEMENT DES LOGES EMPLOYÉS	_
DAME QUAND ON VEUT DU MARBRE	D AILLEURS QUAND ON VA AU PLUTÔT DU BRAS	_
C EST UN SYMBOLE CE MARIAGE	C EST AINSI À S ENMBOLER CE MARIAGE	_
NOUS SOMMES TOUS DÉPUTÉS DE LA NATION	NOUS SOMMES TOUS D ACCUSER DES CHIFFRES ÉPUISÉS DE L ANNÉE	_
BROIE MES OS DANS TA FORCE	BOURDONCLE ALLONS PAS FORCE	_
CE FUT LE COMBLE	CE FUT LE CORPS DE CRAINDRE	_
ELLE Y AVAIT PRIS GOÛT	ELLE N Y A AUCUN CRAYON	_
QUAI DE GRAVELINES À ROUBAIX	QUEL EST DE TRAVENIR D UN HAUT	_
JE N OUVRIRAI PAS LA PORTE	JE N OUVRIRAI PAS LA FRANCE	_
LE POLICIER SORTAIT	LE POLICIER S SORTAIT	_
JE N AVAIS PAS VRAIMENT BESOIN D ELLE	JE VAIS PRENDRE DES RENSEIGNEMENTS	_
LA VEUVE JOIGNIT LES MAINS	LA VÉRITÉ JOIT LES MAINS	_
C EST ELLES	C ÉTAIT LÀ	_
VINGT QUATRE CHAISES NOIRES	AU VINGT DEUX TABLES CHEFS D OEUVRE	_
IL NE FAUT PAS MÉLANGER LES DEUX	ILS ONT PARLÉ DE LEURS GILETS JAUNES	_
D OÙ ÊTES VOUS	D OÙ VENEZ VOUS	_
UNE VOITURE DE SIX CHEVAUX	UNE VOITURE DE SIX CHAISES JAUNES	_
QUEL TRAVAIL FAITES VOUS	QUEL TRAVAIL SOIT EST NOUS	_
UN TROISIÈME COUP	UN TROISIÈME COUP	_
ROUTE DES SAUGES CHARIX	ROUTE DES SOLUCHES CHARLES	_
NE DITES PAS N IMPORTE QUOI	NE L ÉCOUTEZ PAS LES PORTES PAUVRES	_
JE N AI PAS DE PETIT AMI	JE N AI PAS DE CRAYON JAUNE	_
VOUS AVEZ RAISON DIT ELLE	VOUS AVEZ RAISON À EN EFFET	_
LE CHEVAL DE GUERRE	LE CHEVAL DE TERRE	_
JE PARLE D UNE ALLIANCE	JE PARTAGE IL RAYÉ LONGTEMPS	_
VOUS EN AVEZ UN AUTRE	VOUS EN AVEZ OU L AUTRE	_
LE PAIN N EST PAS BON DANS CE MAGASIN	LE PARLEMENT N EST PAS BON DANS CE MAGASIN	_
MOI J AI ACCEPTÉ	MOI J AI ACCEPTÉ	_
EMPRUNTEZ LA AVEC COURAGE	ENTREPRENDS C EST LA VÉRITÉ AVEC COURAGE	_
VOUS POUVEZ LE TROUVER	VOUS TROUVEREZ LE TROUVÉ	_
COÛTE QUE COÛTE	COÛTE QUE COÛTE	_
COMMENT T EN TIRES TU	COMMENT EST EN TRAIN DE FAIRE TUER	_
C EST LA SIENNE QUI EST ICI	C EST LA SIENNE QUI EST ICI	_
EMPRUNTEZ LA AVEC COURAGE	ENTREPRENDS C EST LA PREMIÈRE FOIS	_
VOUS EN AUREZ D AUTRES	VOUS EN AUREZ D AUTRES	_
C EST SALE	C EST ÇA	_
CHEMIN DU GOURD MONTAGNAT	CHEMIN DU COUP DUCOUR MON À NIORT	_
OH MERCI BEAUCOUP	OH L ASSEMBLÉE NATIONALE	_
QUATRE HEURES POUR CINQ LIEUES	QUATRE RAPPORTS POUR S ACCRURENT	_
IL SERA ICI SOUS PEU	IL SE RÉALISA ICI SOUS CEEUX	_
SEPT CHEMIN DE L ARDILA CERZEAU	C EST CHAUDEMENT DE L ARGUMENTATION	_
EST CE QU IL TRAVAILLE BIEN	EST CE QU IL TRAVAILLE BIEN	_
VOUS M AVIEZ DIT QU IL SERAIT FAVORABLE	MAIS IL EST DIT QU IL SE RÉ FAVORABLE À FAVORABLE	_
MADAME N Y EST PAS	MADAME LA RAPIDE N Y EST PAS	_
ET MAINTENANT MON PÈRE ÉCOUTEZ	ET MAINTENANT MAINTENANT MON PÈRE EST COUPÉ	_
CELA NE VA PAS	C EST LA PREMIÈRE FRAPPA	_
AUCUNE AUTRE MAISON	AUCUN NOTRE N ENTRE À MES MAISONS	_
NE TOURNONS PAS AUTOUR DU POT	NE T EN N ENTENDANT PAS AUTANT DU PAUVRE	_
ET CE N EST PAS FINI	ET CE N ÉTAIT PAS FRIGUE	_
C EST TOUT SAUF NÉGLIGEABLE	FAITES TOUT CE FUT FAIT HÉSITER À BIZARRE	_
JE VIENDRAI VOUS CHERCHER	UNE HEURE J AURAIS AIMÉ	_
IL DIT QUE VOUS L ENNUYEZ	QU IL DITIT VOUS L ENNUI	_
M ME ALLAN DESPRÉAUX	MADAME BONNETON À L AIDE DES PRÉLOTS	_
LE SOUS AMENDEMENT EST RÉDACTIONNEL	LE SOUS SOUS AMENDEMENT ET RÉDACTIONNEL	_
IL S ENFONCE LE CAMARADE	ILS SONT FORTS SUR LE CANADIEN	_
À QUELLE HEURE OUVRE LE MAGASIN	À QUELLE HEURE OUVRIRA LE MAGASIN	_
ON VOUS DEMANDERA LA MÊME CHOSE	VOUS DEEZ DEMANDÉ MADAME LA PRÉSIDENTE	_
CET ARTICLE DEUX EST UNE RÉGRESSION	CETTE AFFAIRE S ÉCRIA T IL D ICI L EXPRESSION	_
PERSONNE N A OUBLIÉ LA CHIMÈRE	PERSONNE N A OUBLIÉ LA CHIMÈRE	_
JE LUI ÉCRIVIS UNE LETTRE	JE LUI AI ÉCRIT UNE LETTRE	_
JE VEUX VOUS DONNER UN CADEAU	JE VEUX VOUS DEMANDER UN CADAVRE	_
RÉCEMMENT J AI VU UN HOMME	RESTE À SA MORT J ÉMETTRAI UN AVIS	_
JE SOUTIENS L AMENDEMENT DE MONSIEUR LAURENT	JE SOUTIENS NATURELLEMENT DE MONSIEUR LE RAPPORTEUR	_
MÂTIN ÇA SENT BON	MAINTENANT C EST SAMEDI	_
CEPENDANT JE NE VOULAIS PAS EN ABUSER	CEPENDANT QUE LE NOUVEAU DÉPASSAIT DANS LA BOÎTE	_
JE SUIS SÛR QU ON AIMERA	JE SUIS SÛR QU ON AIMERA	_
NOUS DEVIONS EN PARLER	NOUS DEVIONS EN PARLER	_
VOUS ÊTES LIBRE CE SOIR	POUR QU IL PLEUVRA AUJOURD HUI	_
ROUTE DE MOTZ SERRIÈRES EN CHAUTAGNE	BOULEVARD DEMAINZE SAINT GEORGES SUR ALLIER	_
QUATRE CLOS DES QUATRE FEUILLES	QUATRE CLOS CLOS DES QUATRE CENTS FEUILLES	_
VINGT QUATRE JEUX	VINGT QUATRE JEUX JOLIEUX	_
IL Y A DE LA SAUCE À RAJOUTER	IL Y AVAIT LÀ SOUVENT AJOUTER À RAJOUTER	_
IL SORT ET REVIENT	IL SE HEURE ET REVIENDRA	_
L UNE ET L AUTRE	LE LENDEMAIN	_
BELLE PROPOSITION EN EFFET	LE PROPOSITIONS CONSIDÉRA LES FEMMES	_
CAR TOUT NE RELÈVE PAS DE LA LOI	QUART TU NE RELÈVE PAS DE LA LOI	_
ELLE A L AIR VIEILLE	QUEL EST L AVIS DU GOUVERNEMENT	_
SIX RUE AUX CHIENS	SIX RUE AUGUSTE	_
ALBERT FUT INTRODUIT	ALBERT C EST UN FUT À TRADUIT	_
VAS TU TE TAIRE	VINGT DEUX TABLES TERRES	_
QUI EST LA PERSONNE DEBOUT LÀ BAS	QUI EST L AMBASSADE DE BOULOT DE BOULOT	_
VOUS ÊTES TRÈS GENTIL	VOUS ÊTES TRÈS CHANTÉ	_
J AVAIS DONNÉ LA BOUTEILLE D EAU À TON PÈRE	QUEL EST L AVIS DU GOUVERNEMENT DÉFAVORABLE POUR LES PAUVRES PÈRES	_
MAINTENANT OU PLUS TARD	MAINTENANT ELLES N ONT PLUS TARD	_
JE NE DIRAI RIEN	JE VEUX DIRE AILLEURS	_
POURVU QU ILS NE VIENNENT PAS	POURVU QU IL NE VIENNE PAS	_
IL S EST RETIRÉ DANS SA CHAMBRE	IL S EST RETIRÉ DANS SA CHAMBRE	_
JE SUIS SÛR QUE J AIME	TU ES SÛR QU ELLES AIMAIENT	_
JE SUIS TRÈS STRICT	JE SUIS TRÈS STRICTRITE	_
ALLER À MADAGASCAR	ELLE EST À MADAME LA PRÉSIDENTE	_
BELLE ROSE LE CONDUISIT À SUZANNE	ELLE BOIT TROP DE CONDUISER À CE SUJET	_
IL PARAISSAIT M ÉVITER	IL PARAÎT À SES MESURES DÉJEUNER	_
TELLE N EST PAS NOTRE POSITION	ELLES NE L AI PAS D AUTRE PROPOSITION	_
VOUS AVEZ D EXCELLENTES LECTURES	VOUS AVEZ BESOIN DE ÇA L EMPLOI	_
TU AS RAISON DE RESTER GARÇON	TU AS RAISON RESPECTÉ DANS LA SCÈNE DE RÉSIDENCE	_
EH BIEN LE N HUIT	EH BIEN L EFFET LE LUNDI	_
JE TE DEMANDE MADAME VERDINET	JE TE DEMANDE DEMANDE MADAME LA PRÉSIDENTE	_
MA MAISON EST À CÔTÉ DE LA BANQUE	À ME MAISONS À LA CÔTÉ DE LA BRETAGNE	_
NOS APPROCHES SONT DIFFÉRENTES	NOUS APPRENONS DES FRANÇAIS DIFFÉRENTES	_
ET C EST TOUT	ET C EST POUR VOUS	_
TU ES SÛR QUE VOUS AIMEREZ	TU ES SÛR QUE VOUS AIMEREZ	_
IL VA COMMENCER	IL VA COMMENCER	_
VOICI LES EXPLICATIONS	VOICI LES EFFECTIFS DÉSESPÉRÉS	_
C EST UN CHAMEAU	C EST UN CHARMANT	_
IL VENAIT DU JURA	QUEL EST L AVIS DU GOUVERNEMENT	_
UNE DOUZAINE TOUT AU PLUS	UNE DOUZAINE TOUT AU PLUS	_
LA MAISON EST SUR LA COLLINE	LA MAISON EST SUR LA COLLEINE	_
OÙ VOULEZ VOUS QUE NOUS NOUS RENCONTRIONS	VOUS VOULEZ VOUS QUE NOUS NOUS RENDIONS COMPRENDRE	_
MON CHER VOUS ÊTES UN IMPERTINENT	MON CHAT EST EFFECTIVEMENT IMMOBILITÉ	_
C EST UN FANTASME	C EST À FANTASME	_
C EST CE QUI ME PRÉOCCUPE	C EST CE QUI NOUS PRÉOCCUPE LA TUE	_
PLUS D UN D ENTRE NOUS NE CHANTERA PAS	PLUS D UN D ENTRE NOUS NE CHANTERA PAS	_
C EST LOIN	C EST LOIN	_
QU EST CE QUE JE FAIS ICI	QU EST CE QUE JE SUIS ICI	_
MOI JE N AI RIEN	MOI JE N AI RIEN	_
CHITRA EST EN TRAIN D APPELER PRIYA	CHITRA EST EN TRAIN EST EN TRAIN D APPELER PRIYA	_
OÙ EST L HÔPITAL LE PLUS PROCHE	OÙ EST L AUTEUR DE PLUS À LE PLUS PROROCHE	_
OH POUVEZ VOUS CROIRE	OH VOUS POUVEZ VOUS CROIS	_
ASSUMEZ VOS DÉCISIONS MONSIEUR LE DÉPUTÉ	ASSUMEZ VOTRE DÉCISION MONSIEUR LE DÉPUTÉ	_
BIENTÔT LA PLACE SERAIT NETTE	BIENTÔT LA PLACE SUR LA MALADE	_
J AI VU CINQ D ENTRE EUX	J AI AJOUTÉ DE CRÉER D UN TROUEUX	_
NOUS NE L AVONS DONC PAS FAIT	UNE DERNIÈRE REDOUTABLE TA SŒUR	_
IL N Y A AUCUN ORDINATEUR À LA MAISON	IL N Y A AUCUN ORDINATEUR À LA MAISON	_
RUE LA PÉROUSE REIMS	FOLLAVOINE EH ROUGE CRAIGNIT	_
TU CROIS C EST POSSIBLE	TU CROIS QUE C EST POSSIBLE	_
MONSIEUR EST BIEN BON	MONSIEUR ET BIEN MOI	_
LA ROUTE EST LONGUE	LA ROUTE EST LONGUE	_
LES BONS MÉDECINS	LES BONS MÉDECINS	_
RUE DU MARE AU TOUR DU PARC	RUE DU MARMONT AUTOUR DU PERRÂTE	_
MONSIEUR GALUT S IL VOUS PLAÎT	MONSIEUR GARDE LUI S IL VOUS PLAIT	_
VOUS ÊTES MAL RÉVEILLÉ	VOUS ÊTES MALADE VÉRIFIER	_
IL EST VRAIMENT GRAND	IL EST VRAIMENT PRÉOCCUPÉ	_
VOTRE NOM S IL VOUS PLAIT	VOTRE PRÉNOM S IL VOUS PLAIT	_
SAMEDI 4 OCTOBRE 2008	SAINT MÉDICAMENT DÉ QUATRE OCTOBRE DEUX MILLE HUIT	_
DELPHINE SONT DES HOMMES DE SIX COUDÉES	QUEL EST L AVIS DE LA COMMISSION DE SUPPRESSION EST CONSIDÉRÉE ÉCONOMIQUE	_
IL M AVAIT DIT CELA EN RIANT	ILS NE L AVAIENT PAS DIT CELA EN RIANT	_
C EST RIDICULE	CÉRID EST DÉ TUILE	_
C EST CELUI CI LE TIEN	C EST CELUI CI LE TIEN	_
MAIS QU EST CE QUE TU RACONTES	MAIS QU EST CE QUE TU AS COMPRENDRE	_
CE SONT LESQUELLES	C EST SCANDALEUX KEINEC	_
C EST POURTANT CE QUE VOUS FAITES EN PERMANENCE	C EST POURTANT IMPORTANT C EST QUE VOUS FAITES EN PLEIN VENT	_
IL A QUARANTE SEPT ANS	IL LA CARTAIT DANS SA TÊTE	_
J AI APPRIS L ESSENTIEL	J AI APPUYÉ LA PREMIÈRE DES SENTIELLES	_
IL FAUT CHANGER DE CAP	IL FAUT FAIRE CHANGER L OCCASION	_
NON ÇA POURRAIT TOMBER SUR DES MILITAIRES	LÀ ÇA LA PAROLE EST À MONSIEUR LE SECRÉTAIRE D ÉTAT	_
LA VOIX DE KERAOTRED	JE FERAI DEUX PIÈCES RÊNES TRERAIT	_
ELLE AIME TA SŒUR	ELLE L AIME TA SŒUR	_
CETTE FOUTUE BAGNOLE EST ENCORE EN PANNE	CETTE NUIT LÀ PRÉCISÉMENT L ÉLÈVE LA LANGUE BRETONNE	_
EH BIEN VOILÀ MON VER	EH BIEN VOUS VOULEZ LA MONIRER	_
EN PASSANT TOUDOUX VEUT PRENDRE SON VERRE	EN PASSANT TOUT DE VOUS PRENDRE DES PREMIÈRES SURVES	_
TRAVAILLER PLUS POUR GAGNER PLUS	TRAVAILRIER PLUS PIÈCE QU ON GARDE ÉGAL	_
DANS CE MEUBLE CE QU IL FAUT POUR ÉCRIRE	DANS SES MAINS BLANCS SOCIALES SE FÉLICITAIENT LES FILS ÉTUDES	_
LA ROUTE DEVINT AFFREUSE	LA ROUTE DE VIN À FRANÇAIS	_
RUE DE KORNTAL MIRANDE	RUE DU CORNUTAIL CLÉRANDRET	_
OÙ EST MA FEMME	OÙ EST MA FEMME	_
DES CONDITIONS ONT ÉTÉ POSÉES	DES CONDITIONS ONT ÉTÉ POSÉES	_
CES JAUNES CI	C EST JOLI FILLE	_
UNE BANDE D ENFANTS	UNE BANDE D ENFANTS DE ENFANTS	_
OH AÏE OH AÏE	PAUVRE FEMME PAUVRE HOMME	_
NOUS NE POUVONS PAS TRANSIGER SUR CE POINT	NOUS NE TRONNONS PAS ATTENTIFS À TRANSFERT SUR CE POINT	_
QUAND TOMBE TON ANNIVERSAIRE	QUAND TENTANT DANS L ANNÉE DERNIÈRE GARÇA	_
MAIS JE CITERAI UN SEUL EXEMPLE	MAIS JE VEUX AUSSI CRÉER UN SEUL EXEMPLE	_
RIEN QUE CELA	RIEN QUE C EST LÀ	_
IL EST PERDU LE GARÇON	IL EST PERDU LE GARÇON DU GARÇON	_
J AI ADORÉ CE FILM	J AI PAS DE RESTER EFFECTIVEMENT	_
DEMAIN OU HIER	DEMAIN NOUS PÊCHERONS	_
ELLE LUI DIT TU SERAS PENDU	ELLE LUI DIT SE RAPPROCHANT AU BOUT DE CINQ JOURS	_
QUEL ÂGE AS TU	QUEL EST L AVIS DU GOUVERNEMENT	_
EH BIEN JE VERRAI QU IL N Y A RIEN À VOIR	BIEN JE LE RETIRE ÉGALEMENT LA LOI	_
À ENCOURAGER LA CROISSANCE	ON ENCOURAGEAIT LA PRESSE	_
TOI AUSSI TU ES DE CEUX LÀ	QUAND AUSSI ICI TU ES DE CELA	_
D AUTRES GRANDES CHAISES	D AUTRES GRANDES CHAISES	_
RUE PELLETAN AU NUMÉRO SEPT	RUE PAUL TEMPS AU NUMÉRO SEPT	_
ON TE VERRA DEMAIN	ON NE TE VERRA PAS DEMAIN	_
ELLE REVIENT VERS ANTOINE	ELLE L EMBRASSER ET RENTRÉ	_
C EST LA FAUTE DE QUI	C EST LA FAUTE DE TYAUX	_
ON L A FRAPPÉ	ON L A FRAPPÉ	_
C EST UNE EXPERTE	C EST UNE EXPERTE	_
EN BREF JE DÉMISSIONNE	EN BRÈVE FATIGUÉ JE DÉMÉNAGE	_
EST CE QUE ÇA LUI COÛTE DE L ARGENT	EST CE QUE ÇA VAUT LA PEINE DE L ARGENT	_
LA QUESTION EST VRAIMENT POSÉE SUR LE TERRAIN	L AMBASSADEUR EST VRAIMENT POSÉ SUR LA TIENNE	_
VINGT DEUX RUE D ANNAY	VINGT DEUX RUE D AVÉLIER	_
C EST TOI	C EST TOI	_
JE SUIS UNE HONNÊTE FEMME	JE SUIS SAISI DE DEUX AMENDEMENTS À TRAVAILLER	_
TROIS PAR TROIS	TROIS PARTOUT TROIS ROSE	_
TRENTE DEUX MAISONS BLANCHES	TRENTE DEUX MAISONS BLANCHES	_
QU EST CE QU IL Y A DEDANS	QU EST CE QU IL Y A DEDANS	_
NETTOIE TON OREILLE	NE L ÉCOUTEZ T EN ONT RÉALISÉ	_
JE NE SAIS PAS S IL VIENDRA	JE NE SAIS PAS S IL VIENDRA	_
TON PÈRE EST GRAND	PAUVRE PÈRE AI GRANDE	_
NON AU DOPAGE	NON AUX DEUX PAGES	_
ÇA LUI A COÛTÉ CHER	ÇA LUI A COÛTÉ CHER	_
VOUS NE VOULEZ PAS L ENTENDRE	VOUS NE VOULEZ PAS L EMPEREUR	_
TU PEUX LA RENVOYER CHEZ ELLE	TU PEUX L ANGLAIS ICI J AI ÉLEVÉ	_
COMMENT TU TE SENS	COMMENT PENSE TU DE ÇA	_
QUEL JOUR VIENDRA T ELLE	QUEL CHAUDVILLE VIENDRA T ELLE	_
LE VIN ÉTAIT PIQUANT	LE VINGT EST ÉPUISÉ	_
LE GARS EST TRÈS VEXÉ À CE QU IL PARAIT	LE GARS EST TRÈS VEXÉ À CE QU IL PARAIT	_
PARFAIT VOUS VOILÀ CONVENABLE	PAR FAITS VOUS VOULEZ VOUS L ACCOMPLIR	_
JE SÈCHE SUR NOS CHAUSSETTES	JE SAIS JE SUIS SUR LE CHIEN DE CHAUSSETTES	_
POURQUOI AVEZ VOUS DIT ÇA	POURQUOI AVEZ VOUS DIT ÇA	_
QUE GAGNES TU À L IGNORER	DEUX GARNES TU ASIGNUÉS	_
JE SUIS SÛR QUE J AIMERAIS	JE SUIS SÛR QUE J AIMERAIS	_
MOI J ÉCRIS BIEN	MOI J ÉTIE TRÈS BIEN	_
PAS DE PROBLÈME	UN PROBLÈME	_
IL PARAÎT QU ILS ONT DES GRIEFS	IL PARAÎT QU IL ENSEIGNAIT LES GRENOUILLES	_
EST CE RÉGLEMENTAIRE	EST CE QU ELLE EST DE MONTRER	_
COMMENT GAGNEZ VOUS VOTRE VIE	COMMENT T APPELLES VOUS VOULEZ VOUS VOTRE VIE	_
DAME MONSIEUR C EST UN HOMME	TIENS MONSIEUR C EST À L HONNEUR	_
ILS ÉTAIENT ASSEZ POUR FORMER UNE ÉQUIPE DE VOLLEY	J ÉTAIS EFFECTIVEMENT AU THÉÂTRE FRANÇOIS MILLIONS D EUROS	_
IL Y AVAIT PLUSIEURS RAISONS A MON SILENCE	IL EST LOIN D ICI À RÉSIDENCE DANS LE SILENCE	_
QUANT À MOI JE N IRAI PAS	QUANT À MOI MOI JE NE L AI PAS	_
TEL EST LE GRAND INTÉRÊT DE CET ARTICLE	QUEL EST L AVIS DE LA BRETAGNE ET DE CETTE ACTIVITÉ	_
MOI UN HOMME RANGÉ	MOI À L AU BRJET	_
CORPS À CORPS RÉPÉTAI JE	COMMENT RACOUTE RÉPÉTA T ELLE	_
JE LE RETIRE	JE LE RETIRE	_
LA MER A REÇU LA PREMIÈRE LARME QUE J EUSSE ENCORE VERSÉE	L AMBASSADEUR REÇUT LA PREMIÈRE RÉUNION QUE JE SONT CORRESPONDÉS	_
ET LA FEMME LA SCÈNE ÉTAIT CURIEUSE	ET LA FEMME LA FENÊTRE LA SONNERIE ÉLECTRIQUE	_
QUARANTE SIX OISEAUX	QUARANTE ET UN SIX LIVRES	_
JE NE DÉMARRE PAS DE CE GARAGE	JE NE L AI DÉMARRER PAS DE CE GLORAGE	_
Y EN A T IL ENCORE	TU VERRAS C EST L EMPEREUR	_
AH J AI CHAUD	AH TU CHERCHES	_
J AI ENVIE DE VOIR CE MONE MAGNIFIQUE EN ENTIER	JE VOUDRAIS DRÔLE DE VOIR CE MOT À L ÉCOLE QUI COMMENÇAIT	_
OBJECTIVEMENT C EST UN TRAVAIL DE LONGUE HALEINE	QUEL EST L AVIS DE LA COMMISSION SUR CES AMENDEMENTS IDENTIQUES	_
ELLE EST AUJOURD HUI TOTALEMENT IGNORÉE	ELLE EST AUJOURD HUI POUR AUTANT DU TOTALEMENT ÉVIDEMMENT	_
PAS MÊME LE CAPITAINE NEMO	MADAME LE CAPITAINE LE CAPITAINE LYDIE	_
L ENFANT DONT LE BRAS EST CASSÉ	L ENFANT N ENFOND DANS LE BRAS ET CASSÉ	_
DE QUI EST CETTE ÉCRITURE	REPRIT IL EST FAIT RÉPUBLICAIN	_
VOUS NE LE CONNAISSEZ PAS	VOUS NE LE CONNAISSEZ PAS	_
RUE DU CLÉDAT AU NUMÉRO QUATRE	RUE DU CLDAT AU NUMÉRO QUATRE	_
ET FAIT EN SORTE DE LES ACCOMPAGNER	ET F IL FERA EN SORTR DE DEUX AMENDEMENTS IDENTIQUES	_
VINGT CINQ RUE D ESCONDEAUX	VINGT CINQ RUE DES FRÈRES NOGENT	_
ON SONNE PLUS FORT	ON SONNE PLUS FORT	_
J AI SOIF	J AI SOIF	_
RUE DE L ETANCHE SAINT DIZIER	RUE DE L ÉTENANGE SAINT DIDIER	_
TU AS DES EXEMPLES	TU AS DES EXEMPLES EXAMINANTES	_
QU EST CE QU ILS SONT EN TRAIN DE FAIRE	QU EST CE QU ILS SONT EN TRAIN DE FAIRE	_
C EST DEUX FRANCS	C EST DE FROID	_
IL A L AIR GROGNON TON DOMESTIQUE	IL ALLAIT À LA GRANDE PORTE DONNANT DANS LE VESTIBULE	_
SEIZE RUE DU PÈRE CLÉMENT	SEIZE RUE DU PERTHÉMAIN	_
MA FOI OUI SI VOUS LE TROUVEZ BON	MA FOIS A OUI TU VOUDRAIS TU VOUDRAS	_
C EST LAQUELLE	C EST LA CLEINE	_
VOUS AVEZ FAIM	VOUS AVEZ FAIM	_
ÇA NE FONCTIONNE PAS	CA NE FONCTIONNE PAS	_
PLUS C EST LOIN MIEUX C EST	PLUS C EST LOIN MIEUX MIEUX	_
N Y A QU À NE PAS SE METTRE EN SERVICE	NOUS N ACCEPTONS PAS SE METTRE EN ŒUVRE SPÉCIALE	_
C EST RESPECTUEUX DE L ENVIRONNEMENT	C EST RASSPECT TUE DE L ENVIRONNEMENT	_
JE SUIS SÛR QUE VOUS AIMÂTES	JE SUIS SÛR QUE VOUS AIMA	_
JE ME PERDS	JE MAINTIENS PAR À PARLER	_
ELLE EST TROP BELLE	ELLE EST TROP BELLE	_
COMBIEN EST CE QUE ÇA COÛTERA	COMBIEN COÛTE CE QUE ÇA PEUT TRANQUILLE	_
JE SUGGÈRE LE RETRAIT DE CES AMENDEMENTS	JE SUIS SUR BIEN LE RETRAIT DE CES AMENDEMENTS IDENTIQUES	_
TU AS PEUR	TU AS PEUR	_
RUE DE GUENEBOUT JOUHE	RUE DU LIEUTENANT LES BOTTES JOUÉS	_
NE PAS SUBIR	NE PLEUT PAS SUPPLÉIR	_
IL N Y A PAS DE MAISONS	IL N Y A PAS DE MAISONS	_
À MON PÈRE	À MON PÈRE	_
LA SOIRÉE A ÉTÉ PRÉPARÉE DE LA MÊME MANIÈRE QUE L ANNÉE DERNIÈRE	L ASSEMBLÉE NATIONAL EST EST PRÉPARÉ DE LA MÊME MANIÈRE QUE L ANNÉE DERNIÈRE	_
J AI UNE PAIRE DE CHAUSSURES	J AI PEUR DE CHASSIRS	_
IL FAUDRA S EN ALLER	IL FAUDRA S EN ALLER	_
HABILLEZ VOUS VITE	ABLIÉZ VOUS VITE	_
QUEL JOUR VIENDRA T IL	QUE J AURAIS VRAIMENT T IL	_
JE NE SUIS PAS JALOUSE	JE NE SUIS PAS JALOUX	_
C EST PAS CLAIR	C EST PAS CLAIRE	_
VOUS AUREZ DE L EAU OU DU CAFÉ	VOUS SEREZ DE L HABITUDE DE L HUMANITÉ DU CŒUR	_
MA MÈRE EST DÉCÉDÉE L ANNÉE DERNIÈRE	MA MERLE AVAIT DÉCIDÉ DE LA LIBERTÉ	_
COMBIEN DE LANGUES PARLEZ VOUS	COMBIEN DE LANTERNE PAR LES JOURS	_
DESCENDONS AUX TRENTE DEUX HEURES	DES SOLDATS AUGMENTÉES AU TRENTE DEUX HEURES	_
IL EST TEMPS QUE NOUS FASSIONS QUELQUE CHOSE	IL EST TEMPS QUE NOUS FASSIONS LE FAÇON QUELQUE CHOSE	_
EST CE LÀ NOTRE HOMME	EST CE LÀ VOTRE ERREUR	_
VINGT ÉCUS NOTRE MAÎTRE	VINGT ET UNE LETTRES N ALLÊ ÊTRE	_
ELLE EST JOLIE MA FILLE	ELLE EST JOLIE MA PAUVRE FILLES	_
QUI POUR NOUS SONT DE BONS SOUVENIRS	TU POURRAIS SOUVENIRS SOURCE DE BEAU SAUVEUR	_
JE VEUX MA PIZZA	JE VOUS EMMÈNERAI MADEMOISELLE	_
VOUS N EN FAITES PAS PARTIE	VOUS N EN FAITES PAS PARTIE	_
ELLE EST JOLIE VOTRE RAISON	ELLE JOUIS VOTRE RÉPONSE	_
D UN JOUR DE FÊTE	D AJOUTONS DES FAITES TÊTES	_
LA MACHINE FONCTIONNE	LA MACHINE DE FONCTIONNENT	_
QUI VOUS A TÉLÉPHONÉ	QUI VOUS A T ELLE DES FOLLES	_
ET PUIS IL ÉTAIT MINISTRE	ET PUIS IL ÉTAIT LE LUNDI	_
VINGT TROIS TABLES	VINGT TROIS TABLES	_
IL LA MET DANS SON GOUSSET	IL LA MET DANSAIT DANS VOTRE COUSSIN	_
PLACE DE L ALLÉE À SEIX	GRÂCE DE LA LANGUE À SAXE	_
PEUT ÊTRE LE SAIT ELLE	PEUT ÊTRE CRAIGNANT SON CŒUR	_
MAIS OÙ EST DONC LE PÈRE UBU	LES OUVRIERS DOIVENT PLUTÔT PLUS EFFICACE	_
LES QUATRE GROS	LES QUATRE GROS GROS	_
MAINTENANT TU PÊCHES	MAINTENANT TU PÊCHES	_
LE RETAIL AU NUMÉRO QUATRE	LE REGARDAIL AU NUMÉRO QUATRE	_
PERSONNE D AUTRE NE SAIT ÇA	PERMETTEZ NOTRE DE NOTRE MAIS C EST ÇA	_
VOUS AUREZ DE L EAU OU DU CAFÉ	VOUS AUREZ PLUS LONG DU QUAI	_
NOUS AVONS ÉTÉ AIMÉS	NOUS AVONS EN EFFET ÉMUE ET M	_
QUATRE AVENUE DU PAREAGE	QUATRE AVENUE DEDANS DU TAILLER	_
À LA MAISON IL Y A TROIS TÉLÉVISEURS	À MA MAISON IL Y A TROIS MOIS ET Y A TROTTÉ DES MISSIONS	_
SUR LE TREIZIÈME	SUR LE TREIZE	_
ALLÉE GRUEL VIRIAT	ALLÉE BRULEY VIEILLE	_
LA FÉDÉRATION DE RUSSIE	LA FILLE LA FIDÉLATION DE LUI	_
DE MONTALIVET LE NOTA	DE MONTALIVET ÉVIDENT LES LETTRES LE NOTAIRE	_
CINQ RUE DU ROQUET	CINQ RUE DU HAUTIER	_
C ÉTAIT UN PREMIER GRIEF	C ÉTAIT UN PROBLÈME LIBRE	_
RUE DE PRÉS CINQUANTE TROIS MILLE SEPT CENTS COURCITÉ	RUE DE PR PRÉSER CINQUANTE TROIS MILLE SEPT CENT CONDITÉ	_
JE FAIS UN PEU L OMELETTE	JE FAIS UN PEU LOURDE	_
FAUT IL VRAIMENT QUE TOUT LE MONDE VOTE	AUSSITÔT IL FAUDRA QUE NOUS RÉUSSIRONS DE NOUVELLES DE DROITE	_
CELA DÉPEND MONSIEUR	CELA DÉPLAIRA DES POINTS MONSIEUR	_
IL N Y A PAS DE BUS AUJOURD HUI	IL N Y A PAS DES BUDGETS DISPONIBLES	_
DONC VA METTRE TA PETITE VESTE	COMMENT PAUVRE MA PAUVRE CAPITAINE	_
IL FAISAIT ATTENTION À NE PAS RIRE	ILS FAISAIENT ATTENTION À NE PAS RÉALISER	_
PLUSIEURS PISTES ONT D ORES ET DÉJÀ ÉTÉ OUVERTES	PLUSIEURS PUISQUEIS SONT DORMIR CES DÉJEUNITS ÉTAIENT OUBLIETTES	_
C EST INGRID QUI VA ÊTRE CONTENTE	C EST L HEURE DU GOÛTER ÉCONOMIQUE	_
SÉANCE EST OUVERTE	CÉLON C EST TOUT L ARGENT	_
VOUS POUVEZ TENIR ÇA POUR MOI	VOUS POUVEZ TROUVER CE PAUVRE MOI	_
ALORS MON GARS	HEIN RIANT MON GAR	_
JE VAIS ME FAIRE LA BARBE	JE VIENDRAI MAINTENANT RAPIDEMENT	_
HIER ELLES PÊCHAIENT	HIER IL PÊCHAIT	_
IL ÉTAIT LAS ET BIENHEUREUX	IL ÉTAIS LÀ ET BIEN ÉVIDEMMENT	_
LES ENFANTS ONT ADORÉ	LES ENFANTS EN FRANCE D UN TONNERRE	_
TOI AS TU DES GANTS	CE SYSTÈME S IL VOUS PLAÎT À QUEL DÉBAT	_
J ÉTAIS À DEUX PAS	J ÉTAIS À DEUX HEURES	_
IL SAIT TRÈS BIEN MENTIR	IL S EST TRÈS BIEN NOS TIERS	_
COMMENT AVEZ VOUS PU ATTEINDRE LE LIEU	COMMENT AVEZ VOUS PRÉSENTÉ UN PEU DE LIRE LE JOURNAL	_
IL A GRANDI	IL APPREND L ANGLAIS	_
IL A CERNÉ CETTE VILLE	ILS LA SERAIENT NÉCESSAIRES	_
UNE PINCÉE DE SEL	UNE PENSÉE CELLESELLE	_
LA PAROLE EST À MONSIEUR JOËL GIRAUD	LA PAROLE EST À MONSIEUR JOËL GIRAUD	_
ROUTE DE SAINTE MONTAINE AU NUMÉRO TRENTE	ROUTE DE SARONTNELLE AU NUMÉRO TRENTE TROIS	_
C EST POUR LA SYMÉTRIE MADAME	C EST POSSIBLE S ÉCRIA T ELLE	_
À TON FRÈRE	À QUOI FAIRE	_
QUI EST CE	QU EST CE QU IL EST	_
ET LE MARIAGE N EST PAS PLUS PROPRE	ET LE MARIAGE N EST PAS PLUS CROIRE	_
DES AMENDEMENTS DE SUPPRESSION ONT ÉTÉ DÉPOSÉS	DES AMENDEMENTS IDENTIQUES DE SUPPRESSION ÉTAIT DÉ POOSÉES	_
VOUS NE ME LAISSEZ PAS ACHEVER	OÙ ON NE ME LAISSAIT PAS CHER	_
LE COMMISSAIRE NAUDIN EST ARRIVÉ	LE COMMISSAIRE DE CLEF À ME DONNER EST ARRIVÉ	_
ON ATTEND LA RÉPONSE	EN ATTENDANT LA RÉPONSE	_
PRIEZ LE DE M ATTENDRE	PRIER LE DE MATHERME MOI	_
VOUS AUSSI SAINT GERMAIN LAISSEZ CELA	VOICI CE GENRE ET S ARRÊTANT LE CÉSS LÀ LÀ	_
VOUS NE LE SAVEZ PAS	VOUS NE LE SAVEZ PAS	_
UNE ODEUR DE ROUSSI	IL EST GARDE ANGLAIS ICI	_
NOUS N AVONS PAS À ROUGIR	NOUS N AVONS PAS À REJEUNER	_
QUAND DONC EN VERRAI JE LA FIN	COMMENT DONC EN VÉRITÉ JE LA FORCE	_
ON COMPREND MIEUX POURQUOI CETTE LOI N EST PAS APPLIQUÉE	ON COMPREND LES PAUVRES PAUPIÈRES POUR ACCEPTER SA CŒUR NE PAS APPLIQUER	_
DEUX MAISONS BLANCHES	DEUX MESSIEURS EN ANGLAIS	_
VOILÀ JUSTEMENT CE QUE NOUS VOULONS APPRENDRE	VOILÀ JUSTEMENT JUSQUEMENT CE QUE NOUS VOULONS APPRENDRE	_
METTEZ VOTRE CHEMISE	MAIS TU VOTRE VOTRE CHAUNIISE	_
NOUS SORTONS D EN PRENDRE	NOUS SORS DORMIR DANS PRESQUE EN PREMIÈRE LECTURE	_
C EST COURT	C EST QUOI	_
PRENANT UN JOURNAL SUR LA TABLE	PRENDRE L ENJOLRAS SUR LA TABLE	_
NOUS EN VENONS À L EXAMEN DES AMENDEMENTS	NOUS EN VENONS AVEC DES AMENDEMENTS IDENTIQUES DES AMENDEMENTS	_
REVENONS EN À LA CROISSANCE	REVENONS ENJOLRAS À LA CROSSESSE	_
C EST POURQUOI NOUS Y SOMMES DÉFAVORABLES	C EST POURQUOI NOUS SOMMES HEUREUX DE VOUS SOUHAITER DES FAVORABLES	_
ON SE DEMANDE QUAND IL PLEUVRA	ON S EST DEMANDÉ QU IL PLEUVRA	_
JE SUIS SÛR QU IL AIMA	JE SUIS SÛR QU IL AIMA	_
REVENONS MAINTENANT EN FRANCE	REVENONS MADAME LA FRANCE	_
JE VOUS AIME	JE VOUS AIDE	_
MAIS LE PEUPLE NE BOUGEA PAS	MAIS LE PEUPLE NE BOUGEA PAS	_
L OISEAU QUI NE CHANTE PLUS	L OISEAU EST TOMBÉ SUR LE CHAMP DE PLUS	_
TIENS EMBRASSE TA BELLE MÈRE PLUTÔT	TIENS EN BROSSE CADAVAIT LE MERCRE PÈRE PUTAU	_
ENLEVEZ VOS CHAUSSURES S IL VOUS PLAIT	ALLONS MES CHERS COLLÈGUES ASSEYEZ VOUS BRIÈT	_
NEUF IMPASSE DES SANS SOUCIS	NEUF IMPASSE DES SANS SOUCIES	_
MON ANNIVERSAIRE TOMBE LE VINGT SEPT AOÛT	N AYEZ L ASSASSIN QU ELLE AURA SA TOUTE	_
LA RUE SE REMPLISSAIT DE BRAVACHES	LA RUE SEMBLAIT S IMPOSSIBLE DE BRAVAGE	_
CELA EST TOUTE SA VIE	CELA EST TOUTE SA HAUT	_
QUAND TOMBE MON ANNIVERSAIRE	COMMENT PAUVRE MAINTENANT MADEMOISELLE	_
CE N EST PAS MA FAUTE S IL N Y A PAS D INCENDIE	CE N EST PAS LA FAUTE QUI ME FEIGNÉ PAR LA FENÊTRE	_
IL SE RASSIED DANS LA BERGÈRE	IL SERA ASSIÉ DANS LA BERGEÈRE	_
MON SALON A L AIR D UN CABINET DE LECTURE	MONSEIGNEUR L ÉVÊQUE LA LANGUE DE CABINET DE L ÉCULTURE	_
LA JOURNÉE S ANNONCE DIFFICILE	LA JOURNÉE S ANNONCE BELLE DÉJEUNAIT	_
VOICI POUR LES DÉPENSES	VOICI TOUT LE DÉPENSES	_
JE PRENDRAI LA MÊME CHOSE	JE PRENDRAI UNE PREUVE DE LA MÊME CHOSE	_
J AIMAIS MIEUX LES CHEVAUX	J AIME MIEUX LES LIVRES LES CHEVAUX	_
EH BIEN EST IL RÉVEILLÉ	LUI IL UTILISAIT LE BRETON RÉGULIÈREMENT	_
RIEN D AUTRE	RIEN D AUTRE	_
L ADRESSE CINQ RUE DESROUSSEAUX	LA RÈGLE ÇA CINQ RUE DES ROSES	_
DONNEZ LUI DES VÊTEMENTS QUI NE GRATTENT PAS	DE NOUVEAU L ONCLE EDME MADEMOISELLE CLAIRE	_
YVONNE QUI VEUT ÉCOUTER	YVONNE QU ILS VEULENT QUI JOUE ÉCOUTAIT	_
IL TRAVAILLE MAL	IL TRAVAILLE D ARRACHE PIED	_
ÇA AUGMENTE D HEURE EN HEURE	SERGENT MON MONDE DE VENIR	_
DEMAIN ELLES PÊCHERONT	DEMAIN ELLE PÊCHERAS	_
TA FILLE EST ELLE PRÉVENUE	TA FILLE ÉTAIT ELLE PRÉSIDENTE	_
VOUS NE PRENEZ RIEN	VOUS NE ME CROYEZ RIEN	_
APERCEVANT EDGARD AU FOND	APERCEVANT SE RENDRE À L HÔTEL AU FOND	_
ES TU MALADE DEMANDÉ JE	ET TU LES L HOMMES DE MON BUDGET	_
UN BILLET ALLER	UN BIED À L ISLE	_
LE COMMISSAIRE TRÈS BIEN	LE COMMISSAIRE TRÈS BIEN	_
PEUT ÊTRE VIENDRA T ELLE QUI SAIT	PEUT ÊTRE VIENDRA T ELLE DU SECRÉTAIRE D ÉTAT	_
IL EST ENTERRÉ	IL EST ENTERRÉE	_
TU ES SÛR QU ON AIME	TU ES SÛR QU ON AIMA	_
IL Y A DES MALADES PARMI EUX	IL EST DE MAL À LA TABLE	_
DEUX TABLES NOIRES	DEUX TABLES NOIRES	_
JE VIENS DE LA METTRE À LA PORTE VOTRE JEANNETTE	JE VIENS LA MAÎTRESSE D ABORD À LA PORTE VOTRE JEUNEÊTE	_
S IL TE PLAIT SUIS MOI	SI TU TE PLAIS SUIVANTE	_
L EMPEREUR LUI DONNAIT LA CROIX	L EMPEREUR LUI TOURNAIT LA CROIX	_
OH C EST TROP CHER	OH C EST TROP CHER	_
VINGT ET UNE TABLES	VINGT ET UNE TABLESTAÊLES	_
IL EN AURA DÉPENSÉ DE L ARGENT	IL EN MOURIR DE DÉPENSER DE L ARGENT	_
ALORS J AI PENSÉ À PRENDRE UN ONCLE	ALORS JE PENSAIS QU IL PENSER À COMPRENDRE	_
FAITES LE TOUR	ÊTES LA RÉPUBLIQUE	_
C EST TOTALEMENT FAUX	C EST TOTALEMENT FAUX	_
JE SUIS SÛR QUE VOUS AIMIEZ	JE SUIS SÛR QUE VOUS AIMIEZ	_
IL EST MALADE	IL EST MALADE	_
ALLÉE BEAU SOLEIL À FIRMI	ALLONS MES CHERS COLLÈGUES ASSEYEZ VOUS	_
TROIS CANTAC LIV	TROIS QUANT À TABLE PLAISIR	_
J ACHÈTE LA LAMPE ÉGALEMENT	J ACHÈTE LA LAMPE ÉGALEMENT	_
NOUS VIENDRONS TOUS	NOUS VERRONS EN EFFET TOUS	_
OÙ POURRAIS JE POSTER ÇA	OÙ POURRAIS JE TROUVE QUE C EST ÇA	_
IL NE FAUT PAS VOUS EN FAIRE	IL NE FAUT PAS QUE VOUS EN FEREZ	_
PAUVRE FEMME LAISSA ÉCHAPPER BERTHE	PAUVRE FEMME LES FEMMES LES SAGES ÉBERES	_
EN CE CAS TU SAIS CE QUI NOUS AMÈNE	EN CE CAS QUI C EST KERAOTRED ÉCONOMIQUE	_
EN VOILÀ UNE PRATIQUE	ON VOULAIT ELLE LE PRATIQUE	_
SE TAIRE ET FAIRE	CETTE FILLE ESSENTIEL	_
QUE JE M EN AILLE	QUE J AIMERAIS	_
IL AVAIT BIEN DORMI PENDANT LA NUIT	IL AVAIT BIEN D ORGANISER POUR DANS LA NUIT	_
ELLE EST MALADE	ELLE EST MALADE	_
HORTENSE AUSSI J AI COMPTÉ SUR VOUS	PORTH TORSE AUSSI JE COMPLÉTERAI SUR VOUS	_
EST CE QUE CES CHOSES SONT DES LIVRES	EST CE QUE CEUX CI SEIZE ANS CE SONT DES LIVRES	_
RUE DU DUCHÉ DE LORRAINE À CONDÉ NORTHEN	RUE DU DU DU SECRÉTAIRE À CÉRÉMONT	_
NOUS N EN SERONS QUE PLUS DÉÇUS	NOUS N EN SERONS QUE PLUS DÉÇUS	_
ELLE VITRIFIE QUATORZE CACHETS	LA VIE FUT EXTRÊME EST CONSIDÉRÉE	_
LA PORTE NE S OUVRE PAS	L APPARTEMENT NE SEMBLAIT PAS	_
VOUS ÊTES TROP AIMABLES	VOUS ÊTES TRÈS AIMABLE	_
MERCI POUR MA NIÈCE	MERCI POUR MA NIÈCE	_
UNE TRENTAINE DE FEMMES	UNE TRENTAINE DE FEMMES DE FEMMES	_
LE GOUVERNEMENT SEMBLAIT SUR LA MÊME LIGNE	LE GOUVERNEMENT NE M EN SEMBLAIT SUR LES MÉDICAMENTS	_
ILS ONT CRIÉ JUDITH	ILS ONT CRIAIT JUDITH	_
J ACHÈTE LE JOURNAL À LA BOUTIQUE TOUS LES JOURS	JE CHERCHE LE JEUNE HOMME ET LE JOURNAL À LA BOUTIQUE TOUS LES JOURS	_
QU EST CE QU ON MANGE AU PETIT DÉJEUNER	QU EST CE QU ON MANGE AU PETIT DÉJEUNER	_
ON DIRAIT QUE VOUS EN ÊTES AMOUREUX	ON DIRAIT QUE VOUS EN AVEZ À MOI	_
IL DOIT ÊTRE QUELQUE PART	IL DOIT ÊTRE ÊTRE QUELQUE PART À QUELQU UN	_
MAIL MOI LA PHOTO QUAND TU L AS	MAIS OÙ EST MOI LA PHOTOGRAPHIE CONDUIRE	_
RUE DU CHÉNOIS À FELON	RUE DU SERGENT À FOLLENTIN	_
DE LEUR FAUTE	DE LEUR FAUTE	_
QUI EST CE QUI SONNE DU COR	S IL EST REST QUI CELLE DU CORPS DU CORT	_
JE VAIS MANGER UNE QUICHE LORRAINE CE SOIR	JE LE MAINTIENS DONC L AMENDEMENT DE SUPPRESSION	_
ALLEZ VOUS FAIRE LA BARBE	ALLEZ VOUS FAIRE ERREUR À BORD	_
AUTOUR D ELLE	AUTOUR DE ELLES	_
EST CE VRAI	EST CE VRAI	_
C EST CE QUE TU VOULAIS	C EST CE QUE TU VOUDRAIS	_
S IL N Y A PAS DE PROBLÈME IL FAUT LE DIRE AUSSI	S IL N Y A PAS DE PROBLÈME IL FAUT LE DIRE AUSSI	_
DE SÉTIER S D	DE CITE EST IL ESSAYÉ	_
SUR LA TABLE	CEUX LÀ LÀ DEDANS	_
LES CHOSES SONT AINSI	LES CHOSES CHOSES SONT ASSIÉS	_
DONC JE SUIS TROP VIRIL	DONT JE SUIS TROUVÉE ICI	_
J AI VU SUR LE TOIT	J AI VU SUR LA TOILETTE	_
TU ES SÛR QUE J AIMERAI	TU ES SÛR QU ELLES AIMERAIENT	_
IL FAUT QUE JE TRAVAILLE PLUS	IL FAUT QUE JE TRAVAILLE TRÈS RÉGULUS	_
LA CONVERSATION S ÉGARA	APPLAUDISSEMENTS SUR LES BANCS DU GROUPE REM	_
C EST MON CAS CE SOIR	C EST MON CAPT À CE SOIR	_
QU EST CE QUE VOUS FAITES DIMANCHE	QU EST CE QUE VOUS FAITES DIMANCHE	_
RUE D ELBINGERODE À BOULIGNY	RUE DE L ABBÉ BENJOUVRE D A POLIGNY	_
QU EST CE QU IL Y A ICI	QU EST CE QU IL EST AINSI	_
C ÉTAIT UN AMENDEMENT DU RAPPORTEUR	QUEL EST L AMENDEMENT DU RAPPORT DU RAPPORTEUR	_
ALLÉE CONSTANT FEINTE LAVAL	ALLEZ CONTINUER SANS FERMER LA PORTE À ELLE	_
EXCLAMATIONS SUR LES BANCS DU GROUPE UMP	EXCLAMATIONS SUR LES BANCS DU GROUPE SRC	_
TU PARS À QUELLE HEURE	TU PENSES QU À CELLE LÀ C EST L HEURE	_
RUE PIERRE BOUTY À BRANTÔME	RUE PIERRE BOTTIER À BRASTON	_
QUEL BUT AVEZ VOUS DANS LA VIE	QUEL EST L AVIS DU GOUVERNEMENT AVIS DÉFAVORABLE	_
SIMON RENARD VOUS VERREZ	SINON BONHEUR VOUS ÊTES BÊTE	_
MON ÉPOUX EN ÉTAIT INDIGNÉ	ON EÛT DIT POUR LES ÉTABLISSEMENTS	_
LE JEUNE HOMME DUT S EXÉCUTER	LES GENS MAUDITS DU SERVICE J ÉCRITAIS	_
LUI IL AIMAIT	LUI IL EST AIMÉ	_
LE GRAND PÈRE EST FATIGUÉ	LE GRAND PEUPÈRE EST FATIGUÉ	_
JE N AI PAS LE TEMPS LÀ	J AI PAS LE TEMPS LÀ	_
LE MARIAGE N EST PAS FAIT	ON NE GRIMPE SUR LES PASSANTS	_
VOILÀ MME SMITH	VOILÀ MADAME LA SECRÉTAIRE	_
ELLE LE POSE SUR LA CHEMINÉE	ELLE LE POSE SUR LA CHEMINÉE	_
C EST VIEUX OU NEUF	C EST BIENTÔT LE LUNDI	_
RUE DU VIOLON AU GRAND BOURG	RUE DU GÉNÉRAL PRADES À PRADES	_
TU T ENNUIES N EST CE PAS	TU T EN N ESSAIERAI D ESPOIR	_
L EAU EST MOLLE	NON ÉMOIRE	_
REGARDEZ LE NOMBRE DE LOGEMENTS CONSTRUITS	ON GARDE ÉGALEMENT METTRE LE NEZ DEHORS DE LEURS PROFESSIONNELS	_
IL OBJECTE IL RÉSISTE	L OBJECTIF EST DE PRISONNIERS	_
LE DOIGT MARQUE LA DIRECTION	DEPUIS LONGTEMPS QUE L EXÉCUTIF	_
CELA N A PAS DE FIN SI L ON DOIT INVITER TOUT LE MONDE	CELA N A PAS DE FAÇON SUIVANTE ON EST EXTRÊMEMENT BELLE	_
LA TOURTERELLE MÂLE	LÀ TOURNERAIT ELLE MÊME	_
QU EST CE QUE VOUS AVEZ	QU EST CE QUE VOUS ALLEZ	_
RUE DU JURY À ACY	RUE DU JURIET À ASSIÉ	_
SOYEZ DONC RASSURÉE	SOYEZ DONC TRANQUILLE	_
SOYONS AMBITIEUX AUJOURD HUI	SOYEZ Y ICI AU JEANJET	_
DU BON TRAVAIL	LES BONS TRAVAILLER	_
JE N AI PAS ENCORE DÉCIDÉ	JE N AI PAS ASSEZ ENCORE DÉCIDÉS	_
IL Y A UN PUITS MAIS L EAU EST SAUMÂTRE	IL Y A UN PUITS MAIS L EAU EST SAUMÂTRE	_
SANS CELA NOUS N Y ARRIVERONS PAS	CE SYSTÈME NE N Y AILLE VOULU PAS	_
DU THÉ OU DU CAFÉ	DU THÉ OU DU CAFÉ	_
LE ROYAUME DE DIEU	LA ROYENNE L A DITIEN	_
OÙ POURRAIS JE LOUER UNE VOITURE	VOUS POUVEZ RÉFLÉCHIR UNE VOITURE	_
J AI DONNÉ MA DÉMISSION	J AI DONNÉ MAUVAIS MA DÉMISSION	_
VOTRE PÈRE EST À LA MAISON	VOTRE PÈRE ÉTAIT À LA MAISON	_
QUELQUES MINUTES SE PASSÈRENT	QUEL EST L AVIS DU GOUVERNEMENT CES FACIÈRES	_
JE NE DIS PAS	JE NE DIS PAS	_
IL JOUAIT AVEC TOI	IL JOUAIT AVEC TOI	_
JE SUIS SÛR QUE J AIMAI	JE SUIS SÛR QUE J AIMAIS	_
SI ELLE VIENT OU SI ELLE NE VIENT PAS	SI ELLE VIENT OU SI ELLE NE FLATT PAS PAS	_
UN PEU D OR	UN PEU D AIDE	_
IL EST DANS LA 7È RUE	IL EST DANS LA SEPTIÈME RUE	_
MERCI MONSIEUR LE DÉPUTÉ	MERCI MONSIEUR LE DÉPUTÉ	_
D OÙ VIENS TU	D OÙ VIENT TU AS TU	_
NEUF RUE PIERRE CORBIER	NEUF RUE PIERRE CIRCULT	_
TRENTE TROIS PETITES FEMMES	TRENTE TROIS PETITES FEMMES	_
ILS SONT EN TRAIN DE DORMIR	ILS SONT EN TRAIN DE DORMIR	_
LE PETIT GARÇON AVAIT LES YEUX BLEUS	PEUT IL EST GARÇON À LA RÉPUBLIQUE	_
ATTENDS QUE LA CHAMBRE SOIT EN VACANCES	ATTENDS TORRENT QUE LA CHAMBRE SEUT DE RÉPONSE	_
AU DELÀ CE SERAIT INDÉCENT	AU DELÀ CE SERAIT UN DÉÇON	_
LE COFFRE EST BON	LE TEMPS C EST BEAU	_
C EST LA VÔTRE	C EST À MOI DE JOUER AUTOUR	_
ILS SONT EN TRAIN DE COURIR	IL FAUT FAIRE REPRÉSENTÉS DEPUIS LONGTEMPS	_
MAIS LA CROISSANCE MARCHE SUR DEUX JAMBES	MAIS LA TROISIÈME S ANNONCE MARCHAND DE JARDIN	_
GUIDE À DROITE	DIEU D ART VOTERAT	_
MAINTENANT ELLES PÊCHENT	MAINTENANT ELLES PÊCHENT	_
IL FUT UN DIVORCE VIVANT	IL FUT UN DÎNER L IMPORTANCE DE CE LIVRE	_
J ÉCRIS DES LIVRES	J ÉCRIS DES LIVRES	_
IL N Y AVAIT POURTANT PAS EU DE BOUSCULADE	IL N Y AVAIT POURTANT PAS LES PAUVRES PAILS DE BOUSCULADES	_
IL FAUT OBÉIR AUX MORTS	IL FAUDRA DÉILLEIR AU BOUT DE BUREAU	_
UN VIEUX TRUC	UN VIEUX RÉPUBLIC	_
QUAND L AVIEZ VOUS VUE EN DERNIER	QUAND LA VILLE VOUS AUREZ VOUS D ARGUIS	_
SAINT GUELTAS EST PRISONNIER DES CHOUANS	SAINT GUELTAS EST PRÊTE À PRÉSENT DES CHOUANS	_
JE T AI APPELÉ POUR CAUSER	J ÉTAIS ABSOLUMENT PAULINE POUR QUE JE PÊAIS	_
UN FUTUR LOINTAIN	CE QUI N A PAS FIXÉ SUR VOS TERRITOIRES SEMAINES	_
IL Y A DE LA PLACE POUR TOUTES LES OPTIONS	IL Y A DE LA PLACE POUR TOUTESENTES POUR TOUS LES ASSOCIATIONS	_
QU AVEZ VOUS	QU AVEZ VOUS	_
VOUS NE VOULEZ PAS DE CAFÉ	VOUS NE VOULEZ VOUS LES PAS DES CAFÉS	_
D AUTRES ANIMAUX	D AUTRES ANIMAUX	_
UNE PART DE NOTRE HISTOIRE ET DE NOTRE MÉMOIRE	UNE PART DANS DE NOTRE HISTOIRE DE LA TRANSITION ÉNERGÉ MOI	_
VOILÀ LE MODE D EMPLOI	OÙ EST LE MATIN	_
CES JAUNES LÀ BAS	CE GÂTEAU LÀ BAS	_
LE SOLEIL ÉTAIT EN TRAIN DE BRILLER	LE SOLEIL ÉTAIT PAUVRE ÉTAIT EN TRAIN DE BRILLER	_
UN DEMI MORCEAU	ELLES DEUX MILLE MURMURES	_
ON VA À LA MANIF TU VIENS AUSSI	ON VA LANCER LA LISTE QUI VIENDRA AUSSI	_
DIX RUE DE DENNY	DIX RUE DE DENIY	_
OH VOUS SAVEZ DE MA PLACE	OH VOUS SAVEZ DANSER DE LA PLACE	_
IL FAUT RETIRER CES AMENDEMENTS	FLORENT RETIREZ CES AMENDEMENTS IDENTIQUES	_
CHEMIN DE LAPEYRIERE BESSENS	CHEMIN DE LA PÉRIGÈRE L ESCASSE	_
IL EST NEUF HEURES	IL EST NEUF HEURES	_
ILS TROUVERONT LE FAIT TOUT SIMPLE	IL TROUVA AVOIR ENSEIGNANT LA FÊTE SAULES	_
ELLES ELLES LISENT	ELLES ELLES LISENT	_
LUI AS TU TOUCHÉ UN MOT DE TES INTENTIONS	L ÉQUIPE TOUCHÉ À VOULUT LA RELEVER DES ATTENTIONS	_
UN RUE DU PONT ROYAL	UN RUE DU POISAYAL	_
MARIE MAHIEU LANGUE FRANÇAISE	MARIUS IMAGINE LA PREMIÈRE FOIS	_
IL N EST PAS CENSÉ PLEUVOIR DEMAIN	IL N EST PAS CENSÉ PLEUVOIR DEMAIN	_
AH TRÈS BIEN ALLEZ CHERCHER DES TULIPES	AH TRÈS BIEN À L OCCASION DE CHERCHER DES TULS	_
PEU SONT VENUS MANGER CE SOIR	PLUS SE RENDRE À VENDRE MANGER CE SOIR	_
UN OEUF MOYEN	À NEUF HEURES MOINSILLANT	_
POURQUOI EST IL VENU ICI	POUR QUOI ÉTAIT IL VENU ICI	_
RUE DES GEORGES AU NUMÉRO TREIZE	RUE DES GENGES DE GÊNES AU NUMÉRO TREIZE	_
RUE DE DANJOUTIN À ANDELNANS	RUE DE DAMEUXZ À ANGOULÊME	_
LA PAROLE EST À MONSIEUR JULIEN AUBERT	LA PAROLE EST À MONSIEUR PHILIPPE GOSSELIN	_
QU EST CE QUE TU VAS FAIRE MAINTENANT	QU EST CE QUE TU AS FAIT	_
JE FERAI BIEN CELA POUR VOUS DIT JEAN LE PAUVRE	JE FERAI BAISSER D ABORD IMPOSSIBLE DIT JE LE PENSE	_
RUE PICAUCEL QUARANTE HUIT MILLE MENDE	RUE DU PUY CONSEIL QUARANTE HUIT MILLE MENDE	_
VINGT QUATRE JEUX INTÉRESSANTS	VINGT QUATRE JEUX INTÉRESSANTS	_
MAIS CHACUN VEUT AVOIR LE SIEN	MES CHERS COLLÈGUES AVANT LE CICE	_
ELLE EST FATIGANTE	ELLE EST FATIGUÉ	_
IL VA À CHEVAL	IL VA À CHEVAL	_
PUISQU ELLE N EN VEUT PAS	PUISQU ELLE NE REGARDE PAS	_
LA CRISE LES A FRAPPÉ	LA CRISE LES A FRAPPÉS	_
ON PRÉFÈRE PAR CONSÉQUENT LE CHAOS	ON PRÉFÈRE PASSER PAR CONSÉQUENT LE CŒUR LE CA OÙ	_
CET ANIMAL D AUSTRALIE	C EST TELLE AMENDEMENT DE COHÉRENCE D OBSTRUIRE	_
IL NE DEMANDE PAS	IL NE DEMANDAIT PAS	_
TRENTE HUITIÈME ANALYSE	SON REPRÉSENTANT ACTUELLEMENT À LA LISTE	_
ENTREPRENDRE ET RÉUSSIR	ENTREPRENDS CRAINDRE RÉGULIÈREMENT	_
POURQUOI BAISSEZ VOUS LES PRIX DEMANDA T IL	POURQUOI ME SEMBLEZ VOUS LES PRIES DEMANDA T IL	_
TROIS RUE JÔMERAY	TROIS RUE JEAN MARIEY	_
RUE DE CHAMPNOVAZ À CHALLEX	RUE DES CHAMPS BOUVINS À VALLASSAC	_
UN BON MORCEAU DE PAIN	APPLAUDISSEMENTS SUR LES BANCS DU PAIN	_
ON TRINQUAIT À LA RONDE	ON TRAÎNAIT À LA GRANDE DERNIÈRE DEUX	_
A DROITE LA COUR DU LYCÉE	À DROITE LA PORTE DU MUSÉE	_
DES PAS FURENT ENTENDUS	ET ELLE PASSE SUR T TEMPS ANTDUE	_
VEUT IL DANSER AVEC TOI	VOUS RETIREZ D EN SAVEZ TOI	_
ET TU SAIS CE QU IL LUI EST ARRIVÉ	ET TU SAIS CE QU IL LUI A ARRIVI	_
L ACCIDENT EST ARRIVÉ AU CARREFOUR	L ACCIDENT EST ARRIVÉ AU CARREFOUR	_
IL N Y EN A PLUS AUCUN	IL N Y EN A PLUS AUCUNE THÉÂTRE	_
BOUVARD EN RESTA MÉLANCOLIQUE	BOUVARD À RESTAIT TELLES BLESSÉS EN COUPE	_
NOUS NOUS AVONS EU AIMÉ	NOUS NOUS AVONS EU AIMÉ	_
LES GRANDES FILLES	LES GRANDS FILLES	_
MAIS ON L ENTOURE HABILEMENT	MAIS OÙ L ON N ENTENDRAIT ABSOLUMENT	_
J AI MAL DORMI	J AI MAL DORMIR	_
QUELS MÉTIERS FONT VOS PARENTS	QUEL EST L AVIS DU GOUVERNEMENT TOTALEMENT	_
RUE CALOUCHE À VITTEL	RUE CABOS À VITELLES	_
SEIZE CHEMIN DES COTTERELLES	C EST LA SIENNE EST IDENTIQUE À ELLE	_
ALORS VOUS ME PRENEZ	ALORS VOUS ME PRENEZ LE PRET	_
LE PLUS BEAU CHÂTEAU QUE J AI VU	LE THÉÂTRE REPRÉSENTE LA TERRE QUE J AI VU	_
LE DISPOSITIF EST BIEN STRUCTURÉ	LE DISPOSITIF EST BIENTÔT DIRECTEMENT	_
LE TEMPS EST À LA PLUIE	LE TEMPS ÉTAIT EFFECTIVEMENT PLUS	_
UN PETIT MORCEAU	IMP PAUVRE T IL MORÇAIT	_
ALORS ELLE SE CONFESSA	ALORS RESTE À CE CONFESSEUR	_
RUE DU CERCLER À LIMOGES	RUE DU SARCLÉ À LIMOGES	_
VOUS LE DEVINIEZ	VOUS NE DEVEZ PAS ÉVIDEMMENT	_
UN LITRE DE VIN	ON LUI PRÊTE DE VENIR	_
PENSE COMME MOI	PENSANT QUE MORT	_
OH VOS YEUX PARLENT UN LANGAGE CONTRAIRE	OH VOUS NEZ PAS À L ENLÈVEMENT D AUTRES EMPLOYEURS	_
LE FOND OUVRE SUR UN JARDIN	LE FAUTEUIL AU BOUT DE MONSIEUR LE GARDIEN	_
CONCLUT LE MAJOR	COMMENT CURIEUSE LE MAJOR	_
AUSSI FORT QU UN TAUREAU	AUSSI FORT QU UN TAUREAU	_
RUE DE L AURENCE À CHAPTELAT	RUE DE L ORENCE À CHÂTELLERAULT	_
DONNE UN BAISER À MAMAN	DONNE UN BAISER À MAMAM	_
LA PAROLE EST À MONSIEUR LAURENT WAUQUIEZ	LA PAROLE EST À MONSIEUR LE RAPPORTEUR POUR AVIS	_
JE SUIS SÛR QU ON AIME	JE SUIS SÛR QU ON AIMAIENT	_
C ÉTAIT D AILLEURS COMME CONVENU ENTRE NOUS	C ÉTAIT D AILLEURS C EST D AILLEURS QUE LE CONDUIT EMPRUNT	_
JE PRENDRAI UNE SOUPE	JE PRENDRAI UNE LEÇON IMPORTANT	_
MILLE MILLIONS DE BOMBES	L INDUSTRIE AU BONNES	_
J AIMERAIS ALLER À LA MAISON	J AIMERAIS ALLER À LA MAISON À LA MAISON	_
IL LE FAIT	IL LE FAIT	_
RUE DE LA CAPITALE À MARSEILLE	RUE DE LA CAPITALE À MARSEILLE	_
L INVESTISSEMENT DANS L INDUSTRIE EST EN BAISSE	L INVESTISSEMENTS MASSIFS DANS L INDUSTRIE EST EN BASSE	_
ROUTE DE LUBIÈRES VERGONGHEON	ROUTE DE LUEUR VERY BERGON	_
DIX RUE DU GRAND CHÂTELET	DIRI RUE DU GRAND CHÂTELEUN	_
FAIS CE QUE TU DOIS	FAITES CE QUE TU VOUDRAS	_
VOUS ÉTIEZ VENU AVEC VOTRE FAMILLE	VOUS AUREZ ÉTÉ VOIR À VOS AMENDEMENTS AVEC VOTRE FAMILLE	_
PUISQUE C EST MON COUSIN	PUISQUE C EST CE QUE C EST MAINTENANT	_
QUI L EÛT PU PRÉVOIR SE DISAIT IL	QUEL EST L AVIS DU PRÉVOIR C EST DÉJÀ CE DÉJEUNER	_
CENT TRENTE NEUF ET L HISTOIRE DES DEUX TASSES DE THÉ P	CENT TRENTE NEUF ÉLÉPHANTS DEDANS	_
MAIS JE VOIS CE QUE C EST	MAIS JE VAIS VOIR CE QUE C EST	_
JE SUIS PERCLUS PAR CETTE CLARTÉ	JE SUIS PERSUE AVEC PAR CES DERNIERS QUARTIERS	_
ON COMMENCE À VOIR DES PETITS POIS	EN COMMENCE À VOS AMENDEMENTS IDENTIQUES	_
RUE NOËL POINTE AU NUMÉRO QUATORZE	RUE NICOLAS POISSON POUR SOUTENIR L AMENDEMENT NUMÉRO QUATORZE	_
TROIS CENT SEIZE MONTÉE DE L UBAC	TROIS MILLIONS D APPELS TÉLÉPHONIQUES	_
AUJOURD HUI LA PLUIE EST ARRIVÉE	AUJOURD HUI LA PLUIE EST ARRIVÉE ELLE EST ARRIVÉE	_
J EN DONNERAI QUELQUES EXEMPLES	J EN SUIS D AILLEURS AVEC QUELQUES EXEMPLES	_
ROUTE DE CORDON À CORDON	COUDE DE CORDES LE CORDON À CORDES	_
IL AIMA TA SŒUR	IL AIMAIT TA SŒUR	_
UNE PAGE D UN LIVRE	UNE PASAGE JE DANS LE LIVRE	_
TU AS DÛ AVOIR PAS MAL DE FEMMES MARIÉES HEIN	TU ES SÛR QU ON AURAIT AIMÉ DE FAIM ET À MOI	_
ALLÉE DE LA CHÊNAIE AU NUMÉRO CENT QUARANTE	ALLÉE DE LA CHEMINÉE AU NUMÉRO CENT TRENTE	_
DONNEZ JE VAIS VOUS EN FAIRE CHAUFFER	DON MAIS J AURAIS DE L ARGENT À SOUFFRIR	_
MAUDIT VERSAILLES DIT IL	QUEL EST L AVIS DE LA COMMISSION IL EST IDENTIQUE	_
CORBEIL FUT PRIS ET MIS À SAC	QUAND MES FUSILS FURENT PRIS ET UNE ASSIETTE	_
IL REGARDA SA MÈRE AVEC SON SOURIRE MINCE	IL REGARDA MA SŒUR À SA MÈRE AVEC SON SOURIRE	_
AH J AI CHAUD	AH OUI J IRAI	_
TOUT ÉTAIT LÀ	TOUTES LES TÊTES LÀ	_
ÉCOLES DE MÉDECINE ET DE DROIT	ÉCOLE DE MÉDECIN ET DE DROITE ET DE DROIT	_
NOUS SOMMES LE VINGT CINQ AOÛT	NOUS SOMMES BIEN D ACCORD AVEC NOUS	_
C EST UNE BONNE ÉCOLE	C EST UNE BONNE ÉCOLE	_
IL FAUT DONC QUE VOUS ACCEPTIEZ CET AMENDEMENT	IL FAUT DONC QUE VOUS ACCEPTIEZ CET AMENDEMENT	_
J AI FAIT COURIR MA LISTE	JE FERAI CONVERIER À L HISTOIRE MAL	_
DE QUEL HAUTEUR EST CETTE MONTAGNE	QUE QUEL EST L AVIS DE CES AMENDEMENTS IDENTIQUES	_
ET CELA POSE DES DIFFICULTÉS SUR L ENSEMBLE DE NOS TERRITOIRES	ELLE LA POSE L LA POSTE DIFFICILE SUR L ENSEMBLE SUR L ENSEMBLE DES TERRITOIRES	_
HEUREUSEMENT VOUS ÊTES LÀ	HEUREUSEMENT VOUS EXPLIQUEZ	_
MONSEIGNEUR EST TROP BON	MONSEIGNEUR L ÉVÊQUE ET TROMENT	_
DEUX IMPASSE DES CHENES	DEUX IMPASSE DES CHALES DE CHÊNES	_
TROIS RUE EUGÈNE SILLIEN	TROIS RUE EUGANNES CLÉS	_
CET AMENDEMENT NOUS GÊNE	C EST À L AMENDEMENT DE JOHN	_
JE N AIMAI QUE LE RÊVE	J AIME LES METTRAIS TU LE RÊVE	_
VOUS Y ÊTES AUSSI JEUNE HOMME	VOUS IEZ AINSI À SES JAMBES	_
JEAN MARIE C EST UN PRÉNOM COMPLIQUÉ	J EN MARIE À PARIS C EST UN PRÉLÈVEMENT PROPÉTÉE	_
COMMENT LA RÉTABLIR	COMMENT LA RÉPUBLICAIN	_
IL NE RESTE PLUS QU À PASSER À AUTRE CHOSE	IL N Y A AUCUN PUBLIQUE DE PASSER VOTRE CHOSE	_
RUE DE L ARRIOU AU NUMÉRO SOIXANTE	RUE DE LA RIAU AU NUMÉRO SOIXANTE SOIXANTE	_
LES CHOSES QUE JE N AIME PAS	LES CHOSES QUE JE N AIME PAS	_
IL Y EUT UN NOUVEAU SILENCE	IL EST EXTRÊMEMENT AUXOSSIDENCES	_
À TROIS HEURES DE L APRÈS MIDI	À TROIS HEURES DE LA PREMIÈRE DIVISION	_
PERSONNE D AUTRE	MERCI D AUTRES	_
BELLE MAIS LOINTAINE ESPÉRANCE	PÈRE UBU EH À QUEL D ESPÉRANCE	_
MA PAIRE DE CHAUSSURES	MA PAIRE DE CHAUSSURES	_
TU VEUX LIRE TU NE PEUX PAS	TU VEUX DIRE QUI VEUT DIRE QU IL VOUS PLAÎT	_
JE SUIS TRÈS SINCÈRE	JE SUIS TRÈS SATISFAIT	_
LE TEMPS SE REFROIDIT	LE TEMPS SE REFROIDIT	_
SOUS AMENDEMENT DE COORDINATION	SOUS AMENDEMENTS IDENTIQUES DE COORDINATION	_
MAIS TU AS PLEIN DE CHOSES À FAIRE	MAIS TU AS TU AS PLAISANT DE CHEZ AFFAIRES	_
MONTÉE DES GENÊTS MANOSQUE	MONTÉE DES DEUX JUIGNÉES MAL ANNONCE	_
VINGT QUATRE CHAISES EN BOIS	VINGT QUATRE CHAISES EN BOIS	_
À NOUS DE LE PORTER	ALLEZ NOUS DE LE PORTER	_
TU AIMAIS TA SŒUR	TU AIMAS TA SŒUR	_
EH BIEN LE COLONEL M ENVOIE PROMENER	EH BIEN LE COLONEL LE COLONEL N EN REPROCHAIT	_
ON NE PEUT PAS DIRE CELA	ON NE PEUT PAS DIRE ASSEZ LÀ	_
JE SUIS SÛR QUE TU AIMERAIS	JE SUIS SÛR QUE TU AIMERAIS	_
MERCI BEAUCOUP À VOUS	MERCI BEAUCOUP DE COHÉRENCE	_
DEMAIN ELLE PÊCHERA	DEMAIN ELLE PÊCHERA	_
J ENTENDS DES VOIX CE ME SEMBLE	J ENTENDAIS LES VOIR CE MÉCANISMES	_
JE M Y SUIS REFUSÉ NETTEMENT	JE ME SUIS REMETS EN FUS É AIDEMMENT	_
NE FAIS TU PAS TOUT CE QUE JE VEUX	NE FAITES TU PAS TOUT CE QUE JE VEUX DIRE	_
IL EST INDISPENSABLE AFIN DE RÉPONDRE AUX BESOINS DES FRANÇAIS	IL EST INDISPENSABLE DE RATIFIER LA FRANCE DE RÉPONSE AUX RÉPONSES DEVANT LES FRANÇAIS	_
NOUS ATTENDONS VOS RÉPONSES	NOUS ATTENDONS DONC DE VOTRE RÉPONSE	_
TU NE TE SOUVIENS PAS	TU NE DEVINES PAS CE GÂTEAU	_
C EST LA VIE	C EST LA VILLE	_
C EST POSSIBLE MAIS JE VOUS AIME TANT	C EST POSSIBLE MAIS JE VOUS AI LE TEMPS	_
ON NE PEUT PAS TROP DIRE MONSIEUR	ON NE PEUT PAS ÊTRE DIRE MONSIEUR MONSIEUR	_
POURQUOI PAS TOUTE L ANNÉE	ÇA COÛTE VINGT DOLLARS DE CABINET	_
IL ÉTUDIE À L UNIVERSITÉ DE BOSTON	IL ÉTUDIE À L UNIVERSITÉ DE BOSTON	_
MA VIE VAUT CELLE DE CÉSAR	MARIUS VAISAIT DE SES ASSASSINS	_
TU ES AIMÉ	TU ES AIMÉ	_
ON ENTEND UN BRANLE BAS SOURD DANS LA CHAMBRE	L EMPEREUR IMMÉDIATEMENT D ASSURER DANS LA CHAMBRE	_
ILS N ACHÈTENT PAS LE JOURNAL À LA BOUTIQUE TOUS LES JOURS	IL NE M ACHÈTE PAS LE JOURNAL À LA BOUTIQUE TOUS LES JOURS TOUS LES JOURS	_
PRENEZ DES NOTES	PRENEZ DES MÉDECINS	_
J AI UN BOL DE SOUPE	J AI UNE BOÎTE D ALLUMETTES	_
POURTANT IL NE RÉPONDIT PAS	POURTANT IL NE RÉPANDNAIT PAS	_
CECI EST À TON FRÈRE	CE SYSTÈME EST AINSI	_
QUEL DOMMAGE QU IL NE SOIT PAS NÉ QUARANTE ANS PLUS TÔT	QUEL EST L AVIS DE LA COMMISSION IL NE S AGIT PAS D ENTENDRE DU TEMPS	_
POUVEZ VOUS ARRANGER ÇA	POURRIEZ VOUS REJOINDRE ÇA	_
RUE FERDINAND PERRIER À SAINT PRIEST	RUE FERNAND THOMINE PÉRIELLE À SAINT CRISTONNE	_
NOUS SERONS BIEN ICI	NOUS SERONS RENTRÉES DANS LA CUISINE	_
VOILÀ DONC QUELQUE CHOSE	ON VOIT LA DONNANT QU ÊTES LES CHOSES	_
LES BONNES ET LES MAUVAISES	LES BONS ET LES MAUVAISES	_
ALLEZ DONNEZ MOI ÇA	ALLONS DANS LE CAFÉ	_
AVEC ÇA L ESPRIT D UN NIAIS	AVEC ÇA ELLE EST ESPUT D ANNÉE	_
IL EST AU MOINS QUINQUAGÉNAIRE	IL EST LOIN D ICI À QUIER AU THÉÂTRE	_
T AS NOURRI LE CHIEN	TEL EST L OBJET	_
CE CHANTIER A ÉTÉ LANCÉ	CE CHANTIER EST DES AVANCÉES	_
À CAUSE DE QUOI	À CAUSE DE TOI	_
MAIS TEL N EST PAS LE SUJET	MAIS TEL N N N N EST PAS LE SUJET	_
MAIS ELLES SERONT VERSÉES AU DÉBAT PUBLIC	MAIS ACCEPTEZ SUR OUVERTS AU DÉBAT PLUTÔT PUBLIC	_
C EST MA LIVRÉE	C EST MAGNIFIQUE	_
PRISE DE LA VILLE	PRIS DE LA VILLE	_
EUX ILS LISENT	EUX ILS LISENT	_
C EST LA MIENNE	C EST LA MIENNE	_
EST CE QUE NOUS POUVONS AVOIR UN PEU PLUS DE PAIN S IL VOUS PLAIT	EST CE QUE NOUS POUVONS VOUS REMERCIER DE RÉPUBLICAIN S IL VOUS PLAIT	_
LE TERME EST PEUT ÊTRE EXCESSIF OUI	LE CŒUR NE PEUT ÊTRE RÉFLEXI AUX CHIFFRES	_
POUR VOTRE PROCÈS UN AVOCAT	POUR REPRENDRE CROSSAIT À LA VOCATION	_
LA SCÈNE EST À PARIS	LA SCÈNE SE PASSE À PARIS	_
IL N A PAS CORRIGÉ GRAND CHOSE	IL N A PAS COURU CHEZ GRAND CHOSE	_
COMME T Y VAS L ANCIEN	COMME TU VAS VOIR L ANCIEN	_
AH BIEN QUE LE DIABLE L EMPORTE	ADIEU BIEN PEU DE DIRE L EMPEREUR	_
OÙ HABITE T IL	OÙ HABITAIT IL L LÀ	_
ÉTANT CONSÉQUENTS NOUS LE RETIRONS	C EST ENCORE CONSET QUE NOUS LE RETIRONS	_
C EST MONSIEUR SMITH	C EST MONSIEUR MONSIEUR PHILIPPE	_
CECI CELA ICI LÀ	CE SYSTÈME EST SI LÀ	_
QUAND JE CÉDERAI MOI CE SERA POUR LE BON MOTIF	QUAND JE FERAIRAI MOI C EST FRAPPÉ	_
ET TOI QU EST CE QUE TU FAIS	ET TOI QU EST CE QUE TU FAIS	_
TU VAS FAIRE QUOI EXACTEMENT	TU ES SÛR QU ELLES AIMAIENT	_
JE SUIS SÛR QU ELLE AIME	JE SUIS SÛR QU ELLE AIME	_
RUE DES TAPISSERIES PARIS	RUE DES ABBÉS TÊTÈRENT PERRY	_
NOUS SOMMES SIX PERSONNES	NOUS SOMMES CONNUS NÉCESSAIRES	_
ON A DÉJÀ DEMANDÉ APRÈS TOI	ON A DÉJÀ DEUX GÉNÉRAUX DE MON BIEN PRÉPARÉE	_
MA TAILLE C EST HUIT	MATHILDE C EST LUI	_
TRENTE QUATRE ROUTE DE LA VERNELLE	TRENTE QUATRE ROUTE DE LA VERMÉE	_
CE MAIGRE CI	SOYEZ TRANQUILLES AUSSI	_
JE SUIS UNE PERSONNE DIRECTE	JE SUIS UNE PERSONNALIÈRE	_
OÙ CELA CHEZ LE ROI	OÙ SE LÀ C EST LE ROI	_
FAUCHELEVENT FIT UN SOUBRESAUT	FAUCHELEVENT FINIRA SOUFFERT	_
CE SONT DES AMENDEMENTS DE SIMPLIFICATION	CE SONT DES AMENDEMENTS IDENTIQUES DE SIMPLIFICATIONS	_
C EST COURANT DE PRATIQUER AINSI	C EST CONTRÔLE DE PRATIQUES IDÉES AINSI	_
MERCI DE CONCLURE	MERCI DE CONCLURE MONSIEUR LE RAPPORTEUR	_
IL N OSERAIT PAS	TU NE NOUS AS PAS AIR	_
TELLE EST LA RÉALITÉ	QUEL EST L AVIS DE LA COMMISSION AVIS DÉFAVORABLE	_
JE ME SENS COUPABLE	JE NE SAVAIS PAS COMPRENDRE	_
LE PETIT DÉJEUNER EST TERMINÉ	LE PETIT DÉJEUNER EST TERMINÉ	_
J INSISTE CE SONT LES FEMELLES QUI PIQUENT	J INSISTERAI SUR LES FENÊTRES LES FRUITS TOUS LES PUBLIQUES	_
AH CHÈRE ENFANT TU ES LA SEULE JOIE DE MA VIE	AH C EST AUX ENFANT QU IL L ACHÈTE ET LA SEMAINE DERNIÈRE	_
DES PERSONNES RÉPUTÉES	DES PERSONNES RÉPUTÉES	_
IL L A AIMÉE JUSQU À LA MORT	IL N A AI PAS JUSQU À LA MORT	_
ET QU EST CE QUE TU FAISAIS AVANT	ET QU EST CE QUE TU FAISAIS À MOI	_
JE REMERCIE TOUS LES INTERVENANTS	JE REMERCIE TOUT LES ARGUMENTS	_
ÇA NOUS PLAIT ÉNORMÉMENT	ÇA NOUS PLAIT ÉNORMÉMENT À L ENFER	_
IL Y A PLEIN DE TEMPS	J AI APPUYÉ LE TEMPS	_
ELLES ELLES AIMAIENT	ELLES ELLES AIMAIENT	_
LE CURÉ HARANGUA LES PETITS GARÇONS	LE CURÉ VINT À REVENDRE LES PETITS GARÇONS	_
LA RESTAURATION QUI N A RIEN PRODUIT	LA RESTAURATION RESTAITATION QU IL N ARRIVAIT EN PRODUIT	_
CE SOIR NOUS IRONS DANSER	CE SOIR À MONSIEUR HENRI D ANNONÇAIT	_
UNE JUPE QUELCONQUE	UNE VIEILLE PÂTE ELLE CONCOURENT	_
UN RUE DE GÉRANT	UN RUE DE GÉROS	_
IL EST CAPABLE DE NOUS FAIRE PERDRE	IL EST CAPABLE DE NOUS FAIRE PERDRE	_
VOS CHAUSSONS SONT ILS SECS	VOS CHAUSSONS SONT SANS EFFECTIFS	_
EUSÈBE AVEC COMPASSION	LE HÉBERG AVAIT COUTAATION	_
RUE BIGARREAU À KINGERSHEIM	RUE BILL GARER À THION À TIGY SUR CHAMP	_
DANS MON GENOU	DANS L ENJEU	_
ELLE DISPARAÎT À DROITE	QUEL EST L AVIS DU GOUVERNEMENT À DROITE	_
POURQUOI EST CE ENNUYEUX	POURQUOI ESSAIES ESSAYER DE MIEUX	_
ON N EST TOUJOURS PAS DANS LEUR CATALOGUE	ON N EST TOUJOURS PAS DE L ARGENT À L ARRÊT DE BUS	_
IL SE PLAIT À L ÉCOLE	NE SOISEZ PAS À L ÉCOLE	_
ON FRAPPE À LA PORTE	ON FRAPPE À LA PORTE	_
EH BIEN DIS LE	EH BIEN DIT LE DUC	_
ET L UDI	ET L UDI	_
C EST UN MOUCHARD DIT ENJOLRAS	C EST UN MOUVEMENT D ARGUMENTS ENJEU	_
ALLEZ VOUS EN	ALLEZ VOUS EN EN	_
BOUSSÉRONDE BOUSSÉRONDE À PART	BOUSSÉRON BRUSQUERONT D ABORD	_
IL FAUDRA ARRANGER TES VÊTEMENTS	IL FAUDRA ARRANGER VOS VÊTEMENTS	_
IL M A ENVOYÉ PROMENER ÇA LE REGARDE	IL M EN VOIRA VOTRE PROBLÈME ÇA LE REGARDAIT	_
SE FROTTANT LES MAINS	CE FUT FROTTER LES MAINS	_
QUAND ON EST CON ON EST CON	QUANT À TON MÉDICAMENT POUR L ÉCOLE	_
OH JE SUIS SÛR	OH JE SUIS SÛR	_
IL FAUT TOUT FAIRE	IL FAUT TOUT FAIRE	_
VOUS PROPOSEZ D ALLER PLUS LOIN	VOUS PROPOSEZ DE LES PLUS LONGTEMPS	_
PORTE À GAUCHE DEUXIÈME PLAN DONNANT SUR L OFFICE	POURTANT À GAUCHE DEUXIÈME PLAN DONNANT SUR LE VESTIBULE	_
CELA FAIT CINQ MILLIARDS	CELA FAIT CINQ MILLIARDS	_
DEMAIN IL N Y AURA PLUS D ENTREPRISES	DEMAIN IL N Y AURA PLUS D ENTREPRENDRE	_
TONDRE L HERBE ME FATIGUE	TONDRE L HERBE ME FATIGUE	_
S IL VOUS PLAIT VENEZ AVEC MOI	S IL VOUS PLAIT VENEZ AVEC MOI	_
JE SUIS PRÉOCCUPÉ AUSSI	JE SUIS PRIS EN PRÉOCCUPÉ MONSIEUR	_
ET JE VAIS VOUS DIRE POURQUOI	J Y VAIS VOIR VOTRE GARDE POUR TOI	_
JE VOUS EN DONNE LECTURE	JE VOUS EN BONNE MA CLAIRE EST CŒUR	_
MONTRE LE HORION	MAINTENANT ELLE EST AU CŒUR	_
TA MÈRE EST GRANDE	TA MÈRE EST GRANDE	_
ELLE A SOIF	ELLE EST FROID	_
J AIMERAIS AVOIR UNE VOITURE	J AIMERAIS AVOIR UNE VOITURE UNE VOITURE	_
RUE JULIENNE LUC SUR MER	RUE JULIEN HENINE LE PUY SUR MER	_
LE MARQUIS ASSIS SUR LE TABOURET	LE MARQUIS AINSI SUR LE TABOURET	_
LEQUEL VEUX TU	LE QU ELLE VEUT TU LUI	_
C EST GRAND AVAIT ELLE DIT	C EST GRAS AVEC LE THÉÂTRE	_
COMMENT SE POURRAIT IL QUE VOUS REFUSIEZ	COMMENT S APPELLE VOTRE SŒUR	_
NOUS AVONS BIEN LE TEMPS	NOUS AVONS BIEN LE TEMPS LE TEMPS	_
DIS OÙ L AS TU FOURRÉE CRIAIT IL	DIEU OÙ LA TU FUT FOUDROYÉ ET CRIAIT IL	_
EST ON VENU DE CHEZ JANISSET	ET T EN VOULEZ VOUS DE CE GENOUX ET S ANNONÇAIT	_
EN QUEL ÉTAT SONT ILS	ON NE GRIMPE PAS SUR SON TIERS	_
DOUZE RUE DES MARIZYS	DOUZE RUE DES MARIISS	_
RUE DE LA LAITERIE À MARLIEUX	RUE DE LA LES TERRERIE COMMANRIEUX	_
AUSSI BEAU QU UNE ROSE	AUSSI BEAU QU UNE ROSE	_
JE SUIS D ACCORD AVEC CETTE RECTIFICATION	JE SUIS D ACCORD AVEC CES AMENDEMENTS IDENTIQUES	_
ROUTE DE RIOM MANZAT	ROUTE DE RIOUX LOIN LONZET	_
IL EST PLUS QUE TEMPS DE PARTIR	IL EST PLUS DE TEMPS DE TEMPS DE PARTIR	_
MERCI AUSSI À VOUS MADAME LA MINISTRE	MERCI MONSIEUR VOUS ÊTES VOUS MADAME LA MINISTRE	_
JE REGARDE SANS PLUS	JE VAIS DORMIR DE S EN PLUS	_
PARDON C EST EN CHANTANT	PARDON C EST EN CHANTANT	_
LES VRAIS CHIFFRES SERONT CONNUS CE SOIR	LES RÉSIDENCES FRAÎCHAIENT SUR LEURS COLONELS DE CE SOIR	_
CE N EST PAS JOLI JOLI DE DIRE CELA	CE N EST PAS JUSTE LES JOLIES DE JOLIES DE GUERRE SAUVEUR	_
VOUS ÉCONOMISEZ MAL	VOUS ÉCOUTEZ COMME DE NOUS AIMÂMES	_
OUBLIEZ LE PASSÉ	OÙOUIEZ LE PASSAIT	_
SI ELLE PÊCHAIT	SI ELLES PÊCHAIENT	_
À LA BIBLIOTHÈQUE	À L ABBAYE DE TÊTE	_
J AI EU LA MAIN HEUREUSE	QU IL Y EUT LA MAIN DE ROUS	_
CELA FUT GÉNÉRALEMENT PEU GOÛTÉ	CELA SUFFIT MONSIEUR LE RAPPORTEUR QUE LE PRÉCÉDENT	_
JE NE VOIS PAS COMMENT FAIRE AUTREMENT	JE NE REVIENDRAI PAS À MON FIL EN FAISANT LE TRAVAIL MAINTENANT	_
LE MATCH D HIER SOIR ÉTAIT TRÈS PLAISANT	LE MACHINEUR HAVERSA EST EXTRÊMEMENT PLAISANTENT	_
ELLE A AIMÉ	ELLE A AIMÉ	_
LE RAPPORT DES FORCES POLITIQUES ÉTAIT LE MÊME	LE RAPPORTEUR DES FORCES POLITIQUES CES POLITIQUES	_
SA LANCETTE ÉTAIT GRANDE COMME UN SABRE	C EST L ANCIENNE ÉLÉGANT QUE MARCELIN	_
DENIS ESSAYA DE CALMER LE JEU	DENIS ESSAYA DE CAMPAGNE DE CAMPAGNE AU JEU	_
QUEL GENRE DE PERSONNE ÊTES VOUS	QUELLE GENRE DE PERSONNES DE PERSONNES ABOUTENTS ET VOUS	_
MAIS NOUS TENIONS À REMETTRE LES CHOSES AU CLAIR	MESNIL NETTOYA EN REMARQUERANT LES CHOSES AUXQUELS	_
L EFFICACITÉ S IMPOSE À NOUS	LES PETITES CASQUETTES S APAISÈRENT	_
NOUS SOMMES LES PREMIERS	NOUS SOMMES DANS LES PROBLÈMES	_
ET MAINTENANT QUE LA FÊTE COMMENCE	ET MAINTENANT QUE LA FÊTE L A FAIT COMMENANCE	_
VINGT TROIS JEUNES MARINS ÉTAIENT VENUS LA VOIR	VINGT QUATRE CHAISES JAUNES LAIDES ÉTAIENT VENUS LA VOIR	_
ILS SE TROUVAIENT PRIS	IL SE TROUSSAIT LES PRIES	_
VOUS AIMEZ REGARDER LA TÉLÉVISION	VOUS ALLEZ DIRE REGARDEZ GARDE LA TEMPÉRATURE DE LA VISION	_
LES GRANDS ROSEAUX FRÉMISSAIENT	ELLE GRAND ROSE AUX OUTILS FRANÇAISES	_
SEPT CHEMIN OLIVETTO	SEPT CHEMIN DE L ÎLE AU LIEUTENANT	_
C EST UN GRAND HONNEUR POUR TON MAÎTRE	C EST UN DRÔLE DE MONDE AU CONTRAIRE	_
OÙ EST REBEC JAVOTTE	OÙ EST L HÉBECTIF J HABITE	_
TIREZ LES GARS	TIENS AI EST L AIR ELLE GARDA	_
DIX SOLDATS ÉTAIENT EN TRAIN DE TIRER ENVIRON	DIT CE D ARTAGNAN ÉTAIT EN TRAIN DE TIRER AU VIOLON	_
ELLES SONT ENCORE UTILISÉES ACTUELLEMENT	ELLES SONT ENCOURAGEANT AVEC LES EXEMPLES	_
AU CITOYEN CACAULT	AUSSITÔT IL A ÉTÉ COUPÉ	_
LE DROIT EXISTANT VOUS DONNE SATISFACTION	LE DROIT EXISTANT EST EXISTENCE VOUS DONNE DE SATISFACTION	_
IL Y A DE L EAU EN QUANTITÉ	IL Y A DE LEURS OPINIONS TRANQUILLES	_
CE GARS EST TROP BEAU	CE GARS EST TROP BEAU	_
C EST MON FRÈRE AINÉ	C EST MON FRÈRE AINÉ	_
J ESSAIE DE LUI DONNER UN COUP DE POUCE	J ESSAIERAI DE LUI DONNER UN PEU DE POUSSIÈRE	_
UN FAMEUX BAROMÈTRE MON AMI	EN FACE DE LEUR REMETTRE TRANQUILLEMENT LA NUIT	_
C EST M SMITH	C EST MONSIEUR SOUS MAÎTRE	_
ELLE EST PARFAITE	ELLE EST PARTIE	_
TU ES SÛR QUE NOUS AIMERIONS	TU ES SÛR QUE VOUS AIMERIEZ	_
C ÉTAIT LES DISSOUDRE	C ÉTAIT L EXEMPLE DE DIFFÉRENTS	_
ON AIMERAIT UNE RÉPONSE DU MINISTRE	ON ES PRÊ UNE RÉPUBLIQUE DOMINICAIN	_
IL EST 7 HEURES MOINS LE QUART	IL EST NÉCESSAIREMENT À L ÉCART	_
QU AVEZ VOUS JE NE COMPRENDS PAS	QUEL EST VOTRE AIDE JE NE COMPRENDS PAS	_
D UNE VOIX MOURANTE	D UNE VOIX LONGTEMPS	_
CE N ÉTAIT PLUS LE MÊME HOMME	CES MESSIEURS FORT ARROGANTS MAINTENANT MADEMOISELLE	_
VINTGT ET UN LIVRES NOIRS	VINGT ET UN ÉLÉPHANTS NOIRS	_
CHEMIN DE FONTVIEILLE GRASSE	CHEMIN DE FROIDEY À CLERMONT FERRAND	_
C EST DE BONNE POLITIQUE	C EST DE BONNE POLITIQUE	_
VOILÀ UNE RÉALITÉ INCONTESTABLE	VOILÀ UNE RÉALITÉ ÉCONOMIQUE IMPOSSIBLE	_
SALLES HABITUELLEMENT UTILISÉES	CELLE CI A BESOIN APPLAUDISSEMENTS SUR LES BANCS DU GROUPE SRC	_
CELA M ÉTONNERAIT	CELA EST DEHORS	_
CELA EST DÉSORMAIS TERMINÉ	CELA EST EXTRÊMEMENT ÉTABLI	_
TROIS OU QUATRE LETTRES A CINQ SOUS PIÈCE LE MATIN	QUEL EST L AVIS DE LA COMMISSION SUR CES AMENDEMENTS IDENTIQUES	_
LEURS OS CRIÈRENT DE JOIE	LEURS AJOUTILLES CRIÈRENTS DE JOIE	_
IL N EMPÊCHE	UNE LONGUE PUCHECH	_
ET LUI MÊME TRESSAILLIT	ET LUI MÊME PRÉCÉDEMILLI	_
IL N Y A PAS DE CHAT DANS LE JARDIN	NE ME PARAISSAIENT PAS DANS LE JARDIN	_
MADAME GAUDIN QU Y A T IL	MADAME GAUDIN C EST L UTILISATION	_
OUI MAIS ÇA FAIT BISQUER TA FEMME	OUI MESSIEURS N ACHÈTENT PAS LE DISPOSITIF	_
NE SOYEZ PAS INQUIET DE LUI JEUNE HOMME	LE SOLI Y PARLAIT ÉQUIPÉ DE LUI MIEUX JAHOUA	_
EH BIEN PARTONS NOUS	EH BIEN PORTEZ À TABLE	_
CHOUDENS ÉDITEUR À PARIS	CHOUDAT ET DUTAIRE À PART	_
RETIREZ VOUS LA VOIX	RETIREZ VOUS L AMENDEMENT LA VOIX	_
OH NON C EST BIEN DE LA MIENNE	ALORS C EST BIEN DE L AMOUR	_
C EST TRÈS BIEN	C EST TRÈS BIEN	_
IL Y A UN QUELCONQUE LIVRE SUR LA TABLE	IL Y A UN QUELCONQUE DANS MON BUDGET SUR LA TABLE	_
AUTREFOIS ELLES PÊCHÈRENT	AUTREFOIS LES PÊCHÈRENTS	_
VOILÀ LE MYSTÈRE	VOILÀ L HABITTERIE	_
CES POINTS POSENT EN EFFET PROBLÈME	C EST POSSIBLE IMPOSSIBLE DANS SA PROBLÈME	_
AH VOUS M EN DIREZ TANT	AH VOUS MON GARÇON	_
ÉTAIT CE AMBITION OU ÉMULATION	EXCLAMATIONS SUR LES BANCS DU GROUPE SRC	_
JE VIENS DE CHICAGO	LE VIAD EST DE SUPPRIMER	_
ÉCARTONS LES OBSTACLES LES ENTRAVES	ET ENCORE TOUS LES OUTTRES LES ENTRÊTS LES ENTREPRENEURS	_
JOACHIM QUE VOULÉ JE FAIRE D ELLE	TU VOIS QU IL ME VEUT QU IL ME PLAÎT VENDRE JUSQU À BELLE	_
TOI TU AS AIMÉ	TOI TU AS AIMÉ	_
LE CUBISME C EST DE L ART MODERNE	LE BUISSANT C EST DE L ART MODERNE	_
SI LES GENS VOULAIENT BIEN ÉCOUTER	SI LES GENS VIENDRONT DE BIEN ÉVIDEMMENT LES CÔTÉS	_
ILS NUISENT À NOTRE ÉCONOMIE	IL LUI EÛT À NOTRE RÉCOMPENSE	_
LA DROITE C EST MOINS D IMPÔTS	LA DROITE C EST LOIN D IMPÔT	_
JE N AI POINT DE FOI AU MONOPOLE	JE N AI PAS DE CRAYON ROUGE	_
AVENUE DU VERT COTEAU À CANNES	AVENUE DU VERRAQUE CÔTÉ À CLERMONT	_
DE L AUDACE TOUJOURS	DE LEUR ÂGE QUE J AURAIS REÇU	_
J AI LARGEMENT PRÉFÉRÉ LE LIVRE AU FILM	J AI L AIR D UN JEU EN PRÉFÉRAL AU MILIEU DU CONSEIL	_
MAIS JE NE TROUVE PAS LE TEMPS LONG JE LE TROUVE TRISTE	MAIS JE NE TROUVE PAS LE DOMING JE LE TROUVERAI JE LE TROUVE	_
AVEC TENDRESSE AU PUBLIC	AVEC T EN RESTÊCE AU BBBIC	_
C EST QUEL NUMÉRO DE TÉLÉPHONE	C EST QU ELLE LUI EN TOUCHANT LES FEMMES	_
ILS ÉTAIENT VENUS SANS CHAISE	ILS ÉTAIENT VENUS SANS CHAISE	_
IRAS TU TOI AU CINÉMA APRÈS DÎNER	IL A ATTEINT TOUT AU CINÉMA APRÈS APRÈS MIDI	_
OH J Y SUIS ALLÉ SANS Y ALLER	OH JE SUIS ASSEZ ANNÉE S ANNONCE BELLE	_
QU EST CE QUE VOUS ALLEZ FAIRE	QU EST CE QUE VOUS AVEZ FAIT	_
C EST MIEUX ENCORE QU UN MARIAGE BIEN PARISIEN	C EST BIEN CONNU EN CORPS QU UN MARIAGE BIEN PARISIEN	_
TEL EST L OBJET DE L ARTICLE QUARANTE DEUX	QUEL EST L AVIS DU GOUVERNEMENT DE L ARTICLE QUARANTE DEUX	_
MONSIEUR DUBOURG NOTRE VOISIN	MONSIEUR DU COUROIR N ENTRE À VOTRE ÂGE	_
C EST UN LIVRE ÇA	C EST AINSI QU ELLE L EMBRASSER	_
TU M ENNUIES IMBÉCILE	TU M ENNUIES A BAISSÉS	_
ASHWIN EST EN TRAIN D ENSEIGNER	AJOUTEZ LES ENRETS TRANQUILLES DANS SA NICHE	_
IL N Y AURA PERSONNE AU BUREAU DEMAIN	IL N Y AURA PAS SOMMEIL	_
COMME CA TOUT DE SUITE	COMME ÇA TOUT DE SUITE	_
IL N EST PAS VENU AUJOURD HUI	IL N EST PAS VENU POUR J EN LUI	_
ALLER À TABLE	ELLE EST APPARUE	_
IL Y A MIEUX À FAIRE	IL VIENDRA MIEUX AFFAIRES AINSI	_
RUE GABRIEL PERELLE VERNON	RUE GABRIEL TRÉROL À PÉRELLES VERDON	_
VINGT TROIS MAISONS EN BOIS	VINGT TROIS MAISONS EN BOIS	_
ICI NOUS TIENDRONS ENCORE	ICI L OBJET D UN GROUPE ENCOURAGEANT ENCORE	_
JEAN QU IL ACHÈVE SA PHRASE	JEAN TU L AS LA CHÂTE SA FRANÇAISE	_
RUE ROGER FAVRE SEIZE CENT COGNAC	RUE ROGER FRANÇOIS FAISE SA COLOLAQUES	_
J AI BESOIN DE VOIR UN MÉDECIN	J AI BESOIN DE VOIR MES ENFANTS METTRE ÇA	_
REGARDANT À SA MONTRE	GRESLOUP D INDÉPENDANCE À MON AUTRE	_
QUAND VIENDRA T ELLE	COMBIEN VALENT GRAT ELLES	_
REVENONS DONC AUX CHOSES SÉRIEUSES	REVENANT À LONGTEMPS DES AFFAIRES SOCIALES	_
IL FAIT FROID DEHORS	IL FAIT FROID	_
MAIS ÇA Y EST C EST FINI	MAIS ÇAILLAIT C EST JURID	_
J ENLÈVE MON CHAPEAU ET JE REVIENS	J EN AI VOIS MON CHAPEAU ET JE REVIENS	_
ET SI NOUS ALLUMIONS DU FEU	ET SI NOUS ALLONS NOUS ENTENDRESSÉS	_
RUE CÉCILE SAUVAGE À SAINT ÉTIENNE	LE CICE EST SOUVENT FAVORABLE À TITRE	_
CES TUBES LÀ PORTENT LOIN	C EST UNE BELLE IMPORTANTE DE MOI	_
TU AS PRIS L ASCENSEUR	TU AS VU LA SCÈNE DE S EN FAIRE	_
DELOCHE S ÉTAIT ENFUI	DE L ÂGE C ÉTAIT TON FILS	_
VOUS ÉTIEZ ARRIVÉ À TEMPS	VOUS SEREZ TIR RÉVÉRE À TANT	_
NOUS SOMMES DANS LE MÊME ESPRIT	NOUS SOMMES DANS LE MÊME ESPRIT	_
ENCULÉ DE TA MERE	ON PLUS LA RÉPUBLIQUE	_
IL Y A UN GUIDE ANGLOPHONE	IL Y A EU LIEU DANS D AUTRES FEMMES	_
RIEN NE RESSEMBLE AUX ENFANTS DE PARIS	RIEN NE RESSEMBLERONT PAS LES INFORMATIONS DE PARIS	_
JE NE VEUX PARLER À PERSONNE	JE NE VEUX PAS PARTIR À PERSONNE	_
IL FAUT AUJOURD HUI QUE MON FILS SOIT BEAU	ILS FONT GARDER À GENOUX ET MON FILS BEAU	_
EN EFFET MADAME LA PRÉSIDENTE	EN EFFET MADAME LA PRÉSIDENTE	_
ROUTE DE LA CROISETTE AU NUMÉRO DOUZE	ROUTE DE LA CROIZETTE AU NUMÉRO DOUZE	_
EH QUE M IMPORTE	FAIS TU MAINTENANT	_
DAMIENS N Y TENAIT PAS	D AILLEURS L ÉQUIVALENT ILS N ÉTAIENT PAS	_
IMPASSE SAINT BERNARD À PAMIERS	UN IMPASSE SAINT BERNARD APPUYÉ	_
QU EST CE QUE ÇA FAIT COMME BRUIT	QU EST CE QUE C EST FACILE COMME BRILLAIT	_
UN PANTALON TROP GRAND	IMPOSSIBLE DE NOUS TROPRON	_
VIENS AVEC MOI S IL TE PLAIT	VIEILLE AVAIT CÔTÉ AU MOI S IL TE PLAÎT	_
LA PRESSION SUR LES PAYS EMPRUNTEURS A BAISSÉ	LA PRÉFECTURE SUR LE BUDGET EST EN TRAIN DE PLEUVOIR À BAISER	_
C EST UNE OBJECTION	C EST UNE OBJECTIF	_
NE PAS ALLER PAR LÀ	NE PASSEZ PAS AVEC PAR LÀ	_
RUE ROGER TRÉMOULET FLEURANCE	VOUS ÊTES REJEUNER TRÈS MOUILLÉ FLORESSE	_
COMPRENDRE LA VIE DES GENS	COMMENT PRENDRE LA VIE DES GENS	_
QUARANTE ET UN	QUARANTE ET UN ÉLÉPHANTS	_
DEUXIÈME COMBAT D ANGHIARI	DEUX ÉLÉPHANTS NOIRS D ENJOLRAS	_
RUE SYBOSY AU NUMÉRO DEUX	RUE PHILIPPE GOSSEY AU NUMÉRO DEUX	_
RUE DE LA GIRODERIE RAMBOUILLET	RUE DE LA GIROTGUERY À ROMILLY	_
LE SOLEIL S EST COUCHÉ	LE SOLEIL C EST COUCHÉ	_
MONSIEUR CHERPION A DONC RAISON	MONSIEUR CHARTIER CHANTON A ENTREPRISE À PRÉSENT	_
IL Y EUT UN SILENCE	IL LUI EUT UN SILENCE	_
ILS DISPOSENT DES SIÈGES AUTOUR DE LA TABLE	IL DISPOSE DES SYSTÈMES JURIDIQUES AUTOUR DE LA TABLE	_
LA RÉPONSE EST NON MONSIEUR DE COURSON	LA RÉPONSE C EST NON MONSIEUR DE COURSON	_
C EST OUVERT LE MERCREDI	SES LÈVRES BLEUIRENT HORRIBLEMENT	_
IL FAUDRA DONC DU TEMPS	ILS FONT DRA DONC LUI TOTALEMENT	_
TENIR SOURIRE TOUJOURS	UN MILLIEUR SOURIRES ET JAUNES JAUNES	_
EH OUI CE N EST PAS LA MÊME CHOSE	ET OUI CE N EST PAS LA MÊME CHOSE	_
LA PAROLE EST À MONSIEUR ALAIN FAURÉ	LA PAROLE EST À MONSIEUR PHILIPPE NAILLET	_
MOI J AIMAIS	MOI J AI AIMÉ	_
OÙ EST LA VÔTRE	OÙ EST LA VOIX	_
NE LE VOYEZ VOUS PAS	NE LE VOULEZ VOUS PAS	_
IL FAUT LUI DIRE DE SE DÉPÊCHER	IL FAUT LUI DIRE DE SA DÉBUCHE	_
J AIMERAIS FAIRE DU SHOPPING	TU N AURAIS FAVORABLE CHEZ PAYER	_
IL CREVAIT DE SOIF	IL TROUVAIT LES SOLDATS	_
JE NE VEUX RIEN MANGER	JE NE VOIS RIEN MANGER	_
IL A SA CLEF	IL VA S APPLIQUER	_
LES UNES SONT NETTES LES AUTRES BOUEUSES	LES YEUX SOLDATS SONT MAÊTES LES ENTREPRISES	_
BONSOIR NOS MAÎTRES	BONSOIR À LEURS MAÎTRES	_
LA CRISE LES A DUREMENT FRAPPÉS	LA CRISE LES A DUREMENT FRAPPÉ	_
JE NE SAIS PAS BIEN	ELLES ELLES ONT ÉTÉ AIMÉES	_
ALLER SUR LE CHEVAL DE MON FRÈRE	QUEL EST L AVIS DE LA COMMISSION SUR CES AMENDEMENTS IDENTIQUES	_
CONSPIRER DANS CE TEMPS CI CAR NOUS CONSPIRONS	CONSPIRAIT DANS CET ANCIENS QU ELLE NE CONSIDÈRE QUE NOUS CONSIDÉRONS	_
SENTE DU COQ À CRÉPY EN VALOIS	SON BUDGET EST À CRÉPIT MES CHERS COLLÈGUES	_
BATHILDE SE SENTAIT SUFFOQUER	MA PAIRE DE LUNETTES C EST CELUI DE CE FAUTE	_
IL SE MIT À MARCHER RAPIDEMENT	IL FALLAIT M ÉTUDIER À MARCHER RAPIDEMENT	_
AVENUE DES RUCHOUX LIMOGES	AVENUE DES RUSTOCHES L ÉMOGES	_
C EST LE SIEN	C EST LE SIEN	_
UN GRAND ÉLÉPHANT	ELLE L EMBRASSAIENT LES FEMMES	_
OUI N EST CE PAS	OUI N EST CE PAS	_
UNE BOUTEILLE DE BORDEAUX	UNE BOUTEILLE DE BORDEAUX DE BORDEAUX	_
PRENDREZ VOUS UN VERRE D EAU	AVEC VOUS EN VERREZ NOUS VERRONS	_
DANS SON LIT À NEUF HEURES	DANS SON LIT L EMPEREUR À NEUF HEURES	_
CLOS DES VIOLETTES CHÉPY	CLOS DES VIOLETTES CHÉTIIS	_
L AGRESSEUR FUT LYNCHÉ PAR LA FOULE	L AGRICULTURE FUT LONGTEMPS CHEZ PAR LA FOULE	_
IMPASSE DUPONT À MARSEILLE	APPLAUDISSEMENTS SUR LES BANCS DU GROUPE SRC	_
AUJOURD HUI LE TROP PLEIN FISCAL EST ATTEINT	AUJOURD HUI LE TROUPE LA RÉPUBLIQUE JUSQU À L ÉTATEUR	_
QUELLES BRUYANTES VOITURES	LE BRUIT D UN NOUVEAU DÉCRET	_
BORDEAUX ÉTAIT RENTRÉ DANS LE DEVOIR	BOURDONCLE EST RENCONTRÉ DANS LE DE VOIR	_
INTÉRIEUR D UN CABINET DE TRAVAIL	INTERROMPITANT DANS UN CABINET DE TRAVAILLER	_
J AIME BEAUCOUP CEUX CI CEUX LÀ PAR CONTRE PAS DU TOUT	J AIME BEAUCOUP PLUS SYSTÈME SUR LA PART AUX PAUVRES PAUPIÈRES	_
À QUEL LIEU ÊTES VOUS ATTACHÉ	À QUELLE HEURE EST IL VOULUT ATTACHÉES	_
L AVANTAGE SERA LISSÉ	L AVANT DERNAGE C EST RADICAL	_
C EST À QUI	TU T HABILLES	_
ELLE HABITE À RENNES	ELLE HABITE À RENNES	_
ÇA M A ÉCHAPPÉ	FAMAIN IL EST CHARPÉ	_
J AURAI VINGT ANS DANS UN MOIS	J AURAI VOIR LONGTEMPS TOUS LES AMENDEMENTS IDENTIQUES	_
MONSIEUR DE LA PORCHERAIE	MONSIEUR DE LA PORCHERAIE	_
LE GOUVERNEMENT NE S EN DOUTERA PAS	LE GOUVERNEMENT DEMEURE NE S EN DOUTERA PAS	_
C EST AUSSI UNE QUESTION DE PÉDAGOGIE	C EST AUSSI MON QUESTION QU EST CE QUE TU FAIS DEPUIS LONGTEMPS	_
RUE RICE OXLEY AU NUMÉRO TREIZE	RUE L HISTOIRE PHILIPPE AU NUMÉRO TREIZE	_
CELA EST PARFAITEMENT TOLÉRÉ PAR TOUS	CELA EST PARTIE POUR FAIT LONGTEMPS TOUS LES RÉPONSES	_
MOI J ÉCRIS	MOI J ÉCRISSAIS	_
LE JEUDI C EST LE JOUR DES COURSES	LE JUGELISTE EST LE NOUVEAU DÉCRET	_
IL N Y A PAS EU BEAUCOUP DE PLUIE	IL N Y A PAS EU BEAUCOUP DE PLUIE	_
J AI SOIF	J AI SOIF	_
LE MIEUX QUE TU PEUX	LE LIVRE EST DE CUISINE	_
À QUELLE HEURE ILS ARRIVENT	À QUELLE HEURE EST ARRIVÉ	_
NOUS SOMMES DEBOUT	NOUS SOMMES D ABOS	_
LE LENDEMAIN FRAYEUR GÉNÉRALE	LE LENDEMAIN FUTUR GÉNÉRAL	_
JE NE SAIS D OÙ SA MAJESTÉ VENAIT	JE NE SAIS PAS DE SA MAJESTÉ	_
J AIMERAIS QUE CHACUN COMPRENNE DE QUOI IL S AGIT	J AIMERAIS QUE CHACUN QUELQUE CHACUN COMPRISE NE COMPREND PAS UNE COLLECTIVITÉ	_
JE PROPOSE CEPENDANT DE LUI APPORTER UN CORRECTIF	JE PROPOSERAI CEPENDANT POUR DES AMENDEMENTS IDENTIQUES DE COORDINATION	_
C EST UN ÉLÉMENT ESSENTIEL QU IL FAUT GARDER EN MÉMOIRE	CET AMENDEMENT EST SATISFAIT QU IL FAUT ÉVANOUI AUX AMENDEMENTS IDENTIQUES	_
RUE DU PRÉFET DALPHONSE CHÂTEAUROUX	RUE DU PRÉFEDDA ALFRED CINQUANTE À CHÂTEAUROUX	_
IL Y AVAIT DU MONDE DANS LA SALLE	IL Y AVAIT DU MONDE DANS LA SALLE	_
CELA NE S EST PAS TRADUIT DANS LE VOTE	CELA NE S EST PAS TRADUITE À L UTILISATION	_
ELLE M EMBÊTE AVEC SON PARAPLUIE	ELLE M ENNUIE ET AVEC SON PÈRE À PLUTÔT APPUYAIT	_
JE DEMANDE LA PAROLE	JE DEMANDE LA PAROLE LA PAROLE EST À MADAME LURE	_
OH CE N EST PAS PROBABLE	OH CE N EST PAS PROUVÉ	_
ON PEUT DIRE QU ELLE ÉTAIT JOLIMENT TROUSSÉE VOTRE CIRCULAIRE	MON PLAISIR QU ELLE ÉTAIT ÉVIDEMMENT TOUCHEZ VOS CIRCULAIRES	_
C EST À MOI	C EST À MOI	_
VOUS AVEZ DIT CELA PENDANT DIX ANS	VOUS AVEZ DIT CE CELA APPORTE L UN POUR L EN DIX ANS	_
LE SOLEIL S ÉLEVAIT RAPIDEMENT SUR L HORIZON	LES SOLDATS SE LEVERRA TONNANT SUR LE VESTIBULE	_
IL ME RESTE DOLORÈS	IL ME RESTE DE L ASSEMBLÉE	_
LES AFFAIRES N ALLAIENT PAS	LES AFFAIRES AFFAIRES NE L ÉCOUTENT PAS	_
J AI MIS LA MAIN SUR UN TRÉSOR TRÈS HONNÊTE HOMME	JULIE À METTRE À MONSIEUR LA PRÉSIDENTE TREIZEAGE DE LA TABLE	_
À QUELLE HEURE FINISSEZ VOUS VOTRE TRAVAIL	À QUELLE HEURE FINIT SI VOUS VOULEZ VOTRE TRAVAIL	_
LE PLUS VIEUX D ENTRE NOUS	LA PLUS VIEILLE D ENTRE NOUS	_
QU EST CE QUE ÇA VEUT DIRE	QU EST CE QUE ÇA VAUT DIRE	_
MADAME LA BARONNE EST ATTELÉE	MADAME LA BARONNE EST À TOLÉ	_
JE SUIS SÛR QU ILS AIMAIENT	JE SUIS SÛR QU ILS AIMAIENT	_
TRENTE QUATRE FEMMES VERTES	TRENTE QUATRE FEMMES FAMILLES VERTTES	_
IL NE SAIT PAS QUOI FAIRE	IL NE SAIT PAS CONFRÈRE	_
CHEMIN DU PLANTEZ AU NUMÉRO DIX B	CHEMIN DU PLAN DU PONT ET AU NUMÉRO DIX P	_
PUIS IL REPARTIT	PUIS IL REGARDA PARTIE	_
ET LE CANON GRONDAIT	ET LE CALME GRAND MONDONNAIT	_
MAINTENANT C EST BON	MAINTENANT C EST MAINTENANT	_
IL NE M A RIEN CACHÉ	NE M ARRÊTEREZ PAS CHERCHER	_
PAS SEULEMENT DANS CES QUARTIERS DANS LES CAMPAGNES AUSSI	PASSEZ MOI DANS CES CAFÉS DANS LES CIRCONSTANCES DANS LES CAMPAGNES	_
DIX ALLÉE DE L ALAMANDA	DIX ANS PLUS DE LA LANGUEDOC	_
PORTÉE LIMITÉE DONC MAIS UTILE C EST TRÈS IMPORTANT	QUAND IL VIENDRA L UTILISER DONC MONSIEUR LE SECRÉTAIRE D ÉTAT	_
PAS DE DÉLICATESSE	PAS DE DÉVELOPPER L EXEMPLE	_
JE PEUX ME CONNECTER À INTERNET ICI	J HABITE AUX COLLECTIVITÉS TERRITORIALES	_
ONZE RUE FRANCIS DROUHARD	ONZE RUE FRANCIS FEUILLES SEDROS	_
VOUS ME CHERCHIEZ MON DIEU OUI	VOUS ME CHEZ CHERCHEZ VOUS MON DIEU MAUVAIS VOISIN	_
VOILÀ UN AIMABLE CARACTÈRE PENSA T IL	VOULEZ ELLE LES MALHEUREUX LE CARA T ELLE PENSA T IL	_
VOUS ÊTES D ACCORD MAINTENANT	VOUS ÊTES D ACCORD LÀ MOI	_
CERTAINEMENT DIT LE SERGENT	CERTAINS TÊTES MOINS DIT LE CERCUEIL	_
JE VOUS AIME	JE VOUS AI MÊME	_
FAITES VOUS DE MÊME MONSIEUR PEU	FAITES VOUS DE MÊME AMENDEMENT MONSIEUR LE PEUPLE	_
JE CROIS QUE TU N ES PAS DE MON MONDE	JE CROIS QUE QU EST CE N EST CE N EST PAS DEMANDÉ	_
LÈVE LES YEUX	CRIA T ELLE ESSAYÉ	_
J AI BEAUCOUP D EAU	J AI BEAUCOUP D EAU	_
C EST UN DROIT	C EST D AILLEURS	_
JE DOIS PARLER FRANÇAIS PLUS SOUVENT	JE L AI ENCORE POUR LES FRANÇAIS TOUS LES FOYERS	_
QUI EST LÀ	QU IL EST LÀ	_
VÉRITABLE FORCE ELLE LE DOMPTAIT	RÉSIDENCE LE FORT DE FRANCE ET LE DOCTEUR	_
NUL MOYEN DE SORTIR SANS LIVRER LA PLACE AU CLERGÉ	IL EST LOIN D ICI À DE SORTRIÈRE CE N EST PAS LA PEINE DE LA PLACE SON CŒUR	_
CELA ME SEMBLE LA MOINDRE DES CHOSES	CELA ME SEMBLE ESSENTIEL DE LA MOITIÉ DES CHOSES	_
QUEL EST LE CODE DU SECTEUR	DEUX LOTISSEMENT DU CAMP DE TERRE	_
JE VEUX LES ENTENDRE CHANTER ET LES FAIRE DANSER	JE VOULAIS EMBARRASSANT UNE CHAPELLE ET LES FER DANSÇAIENT	_
JE FERAIS PEUT ÊTRE BIEN D ATTENDRE LE DÉGEL	JE FERAI PEUT ÊTRE BIEN LA TOMBE BIEN ATTENDIT LE DÉJEUNER	_
DIX SEPT RUE DE CREC H TANET	DIX SEPT RUE DE CRÉTEAL	_
IL S AGIT DE TOUS SES AMIS A T ELLE DIT	IL S AGIT DE TOUS CES AMENDEMENTS IDENTIQUES	_
L ESPAGNOL REMPLIT TOUT EN FRANCE	QU EST CE QU ELLE EST EN TRAIN D OUVRIR LA FRANÇAISE	_
C EST EN EFFET UN BON ARGUMENT	C EST EN L EFFET DES FEUX À UN BANNARD ÉGALEMENT	_
IL LUI OFFRE UNE CHAISE	IL LUI EFFECTIVEMENT UNE CHAISE	_
MOI NON PLUS	MAINTENANT NOUS PÊCHONS	_
TU ES SÛR QUE NOUS AIMERONS	TU ES SÛR QUE NOUS AIMONS	_
QUAND ÊTES VOUS ARRIVÉ À BOSTON	QUAND EST D OU VOTRE ERREUR À VOS BESOINS	_
RAMASSEZ VOS VÊTEMENTS	RAMASSIA MASSÉE AUX BÊTES MALADES	_
LA PAROLE EST À MADAME MONIQUE RABIN	LA PAROLE EST À MADAME ANNIE GENEVARD	_
IL N ÉTAIT PAS CHAUDEMENT VÊTU	IL N ÉTAIT PAS CHAUDEMENT VÊTUE	_
RUE DES PERRIERS À GLUN	FLUE DES TERRITOIRES INQUIÉTUDES	_
COMMENT ÇA SE DIT EN BRETON	COMMENT C EST CES AMENDEMENTS IDENTIQUES	_
DIS MOI OÙ SONT TES MAÎTRES	DIEU MERCI AUX SOINS LES MAÎTRES	_
TRENTE ET UN LIVRES NOIRS	TRENTE ET UN LIVRES LIBRES	_
MAIS IL LUI REPROCHA DE LA DÉFIANCE	LES ÉDUCTEURS REPROCHENT DE LA DÉFIANCE	_
VOILÀ MA BONNE PRUNETTE CE QUE J AVAIS À TE DIRE	VOILÀ MADAME LA BONNE PREMIER PUBLIQUE QUE J AVAIS BIEN	_
A LA REVUE IL DIT QU IL MANQUE UN HOMME	À LA REVUE LES DIFFICULTÉS LONGTEMPS	_
QUE PENSERAIT LE MAJOR	TU PENSES PRESQUE LE MAJOR	_
IL N EN FUT PAS AINSI	IL N EN FUT PAS INSEILLES	_
IL COMMUNIQUE AVEC LE HUIT ET LE NEUF	IL COMMUNIQUE À RÉTABLIR L ÉTERNITÉ DE L ŒUVRE	_
SIX HAMEAU DU MOULOIS	SIX AMOUREUX DOULOUREUX	_
VOUS TROUVEREZ JUSTE QUE CE SOIT RÉCIPROQUE	VOTRE RENDEZ VOUS CHANGE QUE CE SOIT LE SECRÉTAIRE D ÉTAT	_
LES BLEUS SONT ARRIVÉS LÀ DESSUS	LA BOÎTE SANS TAILLERIER L ADOPTION LÀ DESSUS	_
NOUS AVONS ACHEVÉ L EXAMEN DE LA PROPOSITION DE LOI	VOUS AVEZ ASSEZ RÉFLÉCHIS ET LES ARMES DE LA PROPOSITION DE LA PROPOSITION DE LOIS	_
JE LE SAIS PARBLEU BIEN	JE LE SAIS PAR LE BIEN	_
RUE DU QUART D AVAUX TRENTE NEUF DEUX CENT TRENTE PASSENANS	RUE DU TERTRE D AVOUAN TRENTE NEUF DEUX CENT TRENTE ASSANI	_
PARTOUT OÙ PASSE LE VENT	PARTOUT ON PASSAIT AU VENT	_
TIENS VOILÀ DU BOUDIN	TIENS VOULEZ VOUS L A DU BOULOT	_
VOUS AVEZ RAISON	VOUS AVEZ RAISON	_
FRANCHEMENT JE NE M EN CROIS PAS INDIGNE	FRANCHEMENT JE NE M EN CROIRE PAS À DIRE	_
J AI PARLÉ AVEC LE GARS DE LA GARDERIE	JE PARLAIS AVEC CLAIR AVEC LE GARDE DE GARDERIE	_
NEUF PLACE ANTONIN VINCENT	NEUF PLAN CLASSANS EN TOUT LEURS ENFANTS	_
L UNION DES ENSEIGNANTS DE BRETON	LUILUME DES ENSEIGNANTS S ÉNONÇANT DE BRETON	_
ALORS ÇA TE PLAÎT	ALORS ÇA C EST PLUT	_
ON NE PARLE PAS DE LA MÊME CHOSE	ON NE PARLE PAS DE LA MÊME CHOSE	_
COMBIEN N ONT ILS PAS ÉTÉ ATTRAPÉS COMME CELA	COMME IL Y A LONGTEMPS QU IL PAYE PEUT ÊTRE RAPIDEMENT CELUI LÀ	_
CINQUANTE DEUX RUE DES VIGNES	CINQUANTE DEUX RUE DES VILLENEUILLES	_
MÊME LE RAPPORTEUR GÉNÉRAL EST D ACCORD	MÊME LE RAPPORTEUR GÉNÉRAL GÉNÉRAL GÉNÉRAL EST D ACCORD LES DOCTEURS	_
ET IL ENTRA	ET IL ENTREND	_
CHEMIN DES PÉPINIÈRES GEYSSANS	CHEMIN DES PIPINS DE PÉPINIÈRES DEUX CENT NEUF	_
PLACE DU DIX HUIT OCTOBRE CHÂTEAUDUN	PLASSHE PLUTÔT DIFFICULTEURS AUX CHATS	_
QUATRE BEAUVAIS TRENTE SIX DEUX CENTS À CEAULMONT	QUATRE BOEMONDET TRENTE SIX DEUX CENTS À COLOMBES	_
CE QU IL M AVAIT FAIT LE BRIGAND	CE QUI NE ME RESTAIT FAIT LE BRILLANT	_
MONSIEUR LE RAPPORTEUR A PARTICIPÉ À CETTE AUDITION	MONSIEUR LE RAPPORTEUR RAPPORTEUR A PARTIR À CES OFFICIERS	_
COMMENT JE FAIS AVEC ÇA	COMMENT JE ME FAIS EFFECTATION	_
ROUTE DE LUSIGNY SORNAY	ROUTE DE L HISTOIRE S ARRÊT	_
DEPUIS HUIT JOURS JE M ATTACHE À VOS PAS	DEPUIS HUIT JOURS JOUENT DU JOUR JE M APPELLE JOHN	_
DEUXIÈME ET TROISIÈME ACTES À PARIS	DÉSIGNEMAIS LE TROISIÈME ACTE À PARIS	_
LES BOURGEOIS RIRENT	LES BORDES JOUE MOI RIÈRENT	_
MON BON TIC MON GRAND CÂLIN	MON BRUIT EST PRÊT LE GRAND CLAIR	_
TU ES SÛR QU ELLE AURAIT AIMÉ	TU ES SÛR QU ELLES AVAIENT AIMÉ	_
LE PÈRE ET LA FILLE MONTÈRENT	LE PÈRE EST LA PHILOSOPHE MON TERÈRE	_
NOUS NE PROPOSONS PAS ICI D Y REVENIR	NOUS NE PROPOSRONS PAS EFFECTIVEMENT AUX AMENDEMENTS IDENTIQUES	_
VOUS VOULEZ VENIR AVEC MOI	VOULEZ VOUS VENIR AVEC MOI	_
PEUT ÊTRE MÊME ÉTAIT CE ILLÉGAL	PEUT ÊTRE MAINTENANT MADEMOISELLE EST ASSEZ ÉGAL	_
C EST LES SIENNES	C EST LES SIENNES	_
UNE LEÇON PLUS IMPORTANTE	UNE LEÇONS PLUS IMPORTANTE	_
UNE VIEILLE FEMME	UNE VIEILLE CHARMANTE	_
JE T AVOUE QUE J AVAIS SONGÉ À LUI POUR EMMELINE	JE TE REMERCIE QUE JE RÉFLÉCHIRAI À L MIEUX POUR EUX	_
IL DUT SE RENDRE À L ÉVIDENCE PERSONNE NE PARLAIT DE LUI	IL DU SERVICE À L INITIATIVE PERSONNELLE DE PARLER DE LUI	_
PLACE BOUÉ DE LAPEYRERE À LECTOURE	CLOS OUBLIER DE LA PÉRIÈRE À L ÉCOLE	_
LE PREMIER EST LE TAUX DE FÉCONDITÉ	LE PREMIER AUGUSTE EST TOMBÉ EN FAISANT DU VÉTÉ	_
RECONNAISSEZ LE AU MOINS	RECONNAISSEZ QU EST LE ROI	_
TRENTE ET UNE MAISONS	TRENTE ET UNE MAISONS	_
VIENS QUAND LE TEMPS SERA VENU	VIENNE QUAND LE TEMPS SERA VENU	_
L ASSIETTE EST SUR LA TABLE	L ASSIETTE EST SUR LA TABLE	_
VOUS ÊTES LE BIENVENU	VOUS ALLEZ BIEN VENDUS	_
UN PETIT GARS	UN PETIT GUÉRIDON	_
VOUS CRÉEZ UNE HYDRE À DEUX TÊTES	VOUS CRAIGNEZ UNE IDÉE D ARGENT À DOUTE	_
ELLE REPRIT IL ÉTAIT PERDU POUR MOI	ELLE AURAIT ET EFFECTIVEMENT BUDGET	_
JE VEUX BIEN MON PAPA	JE DEVIENDRAIS MAINTENANT	_
JE NE PENSE PAS COMME TOI	JE LE PENSERA COMME TOI	_
ALORS ELLE S EN VA DANS LA FORÊT ET MONTE SUR UN ARBRE	ALORS ELLE S EN VA DANS LA FORÊT DE LA FORÊT ET MAINTENANT	_
NOUS AVONS LA SEMAINE POUR POURSUIVRE NOS DÉBATS	NOUS AVONS LA SECONDE QUE CELLE DU CONTRÔLE DE LÉGÈREMENT	_
AH NON TU ES BIEN BON	ALLANT C EST BIEN BEAU	_
VOUS POUVEZ DÈS LORS ACCEPTER CET AMENDEMENT	VOUS POURRIEZ DÉ LEUR LEURRE ACCEPTER CET AMENDEMENT	_
J AI TROP PEU D ARGENT POUR ACHETER UR C HARR	J AI TROP PEU D AFFAIRES EN FRANCE SANS RAJOUTER SUR SA CHAMBRE	_
QUATRE VINGT DIX GRAMMES DE SUCRE EN POUDRE	QUATRE VINGT DIX GRAMMES DE SUCRETS DE SUCRECOURT	_
JEAN TU L AS PRÉVENUE	JEAN TU LA PRÊTE À PRÉVENIR	_
C EST L INVENTAIRE	C EST LA LOI	_
ON LÈVE LE COURRIER DEUX FOIS PAR JOUR	ON L AI JE LE CROYAIT DEUX FAUBOURGS PAR JOURS	_
NOTRE PROMESSE C EST QUE LES ENTREPRISES REDÉMARRENT	À NOTRE PROMESSE C EST QUE LES ENTREPRISES LES PRISONNIERS DÉMARCHES	_
A VOUS À VOUS	ALLONS ALLONS	_
IL A BU AUTREFOIS	IL A BU AUTREFOIS	_
LA NOUVELLE VERSION EST BIEN MEILLEURE	À L OCCASION DE LA RECONNAISSANCE RÉGULIÈREMENT	_
DONNEZ LA LEUR	DONNEZ LA LEUR	_
EN L ÉCOUTANT IL RIAIT ET IL PLEURAIT TOUT À LA FOIS	EN L ÉCOUTTANT IL ARRIVAIT ÉPUISÉ TOUS LES TOUTES LES FRANÇAIS	_
C EST UN AMENDEMENT D ARY CHALUS	C EST UN AMENDEMENT RÉDACTIONNEL	_
ET TON PRÉDÉCESSEUR POURQUOI FUT IL RENVOYÉ	LES PEUPLES LIBRES C EST SINGULIERS EN COMPTE QU IL REVENAIT	_
IL PLEUT MAINTENANT	IL PLEUT MAINTENANT	_
DEUX MOTS SEULEMENT	DEUX MESSIEURS	_
JE PARLE MAL L ANGLAIS	JE PARLERAI L ANGLAIS LORSQU	_
CINQUANTE GRAMMES DE FARINE	SA COLLÈGUE GRADE DE FARINE	_
ON VIT ALORS CE QUE C ÉTAIT QUE LE DUC D ANJOU	VOUS VIENDREZ ALORS CE QUE C ÉTAIT À QUE LE DUC D ANJOU	_
C ÉTAIT CE QU ELLE EXPLIQUAIT	C ÉTAIT CE QU ELLE SOUHAITE QU ELLE EXPLIQUAIT	_
LA PAROLE EST À MONSIEUR CHRISTOPHE PREMAT	LA PAROLE EST À MONSIEUR LE SECRÉTAIRE D ÉTAT	_
QUE VOUS AI JE DIT HIER AU SOIR	QUE VOUS ESSAYEZ DE VENIR EN SOOIR	_
JE SOUHAITE CONTRIBUER À VOTRE PROJET	JE SOUHAITE CONTRE TRÈS BIEN VOTRE PROJET PROJET	_
L IMPÔT S IL EST JUSTE EST ACCEPTÉ	MAINTENANT C EST LES JUSTE EXTRACTIITÉS	_
NOUS EN REPARLERONS DANS LES PROCHAINS JOURS	NOUS EN REPARONS PAR LE RÔLE DE PREUVE DANS LES PROCHAINS JOUEURS	_
DU COUP ON EST OBLIGÉ DE CHANGER LE TITRE	DU COUP AU CONTRÔLE AU LIEUTENANT DE CHANGER L OBJET DE L ULTTRE	_
ILS Y SONT	IL ESSAYA	_
CE N EST PAS ADMISSIBLE	CE N EST PAS ASSEZ MONSIEUR	_
RUE DU VÉRON AU NUMÉRO CENT UN	RUE DU VERTEAU AU NUMÉRO CENT UN	_
UN PHARMACIEN DOIT TENIR SON RANG	UN FER MONSIEUR NICOLAS DE NICOLAS SARKOZY	_
ROSE COMME POUR SE JUSTIFIER	ROSE COMME POUR CES JUSTIFIER	_
RUE DES TROIS RÉGIMENTS CINQUANTE TROIS MILLE LAVAL	TROIS RUE DE TROISROGISON CINQUANTE TROIS MILLE TROYES	_
ON S ÉCRASERA À LA MADELEINE AVANT DE S ÉCRASER À LA COMÉDIE	POUR CES TROIS AMENDEMENTS IDENTIQUES AVIS DÉFAVORABLE À CES AMENDEMENTS IDENTIQUES	_
MONSIEUR PAPAVERT QUEL ENNUI	MONSIEUR PAPAIER CATHERINE KEINEC	_
PEUT ON REPARTIR EN ARRIÈRE	PEUT ÊTRE RÉPONDIT PARTICULIER ROYALE	_
DAME DEPUIS QUELQUE TEMPS	DAME UNE DEPUIS QUELQUE TEMPS LE TEMPS	_
COMMENT VOUS ÊTES PARVENUE À LES APAISER	COMMENT VOUS N ÊTES PAS RÉGULIÈREMENT LES APPLICATIONS	_
CITÉ DU CAYLA À ARPAJON SUR CÈRE	CITÉ DU CALS DU CAILAL À ARPAJON SUR CÈRE	_
CELLE CI EST SEREINE ET L AUTRE EST ANGOISSÉ	CELLE CI EST SEREINE ET L AUTRE EST ANGOISSÉ	_
IL MANGE MAIS C EST AVEC DÉGOÛT	J AI MANGÉ MES AFFAIRES AVEC DES BOUTONS	_
ON CITE SOUVENT EN EXEMPLE LA SUÈDE ET LE DANEMARK	ON SYSTÈME S EFFONDRA LES NANTES PASSÉES DE LE DOMESTIQUE	_
VOUS M AVEZ AMENÉ DES FLEURS	VOUS M AVEZ AMENÉ DES FLEURS	_
LA FRANCE SE SAUVA SEULE	LA FRANCE SE SOUMET SUR BAS SEUL	_
IL FAUT AUTORISER LE CHOIX	IL FAUT UTILISER LE TÉLÉPHONE	_
JE VEUX ENTRER EN RELATION AVEC NOTRE AMBASSADE	JE VOUDRAIS REVENIR AUX RELATIONS AVEC CONTRÔLER DE TRANSFERT	_
ELLE ENTRE À GAUCHE AVEC SES DEUX BOUTEILLES	ELLE ENTRE À GAUCHE LES DIFFICULTÉS DE BOUQUET	_
VOILÀ UNE LEÇON D ÉCONOMIE	VOILÀ UNE LEÇON D ÉCONOMIE	_
SI SEULEMENT C ÉTAIT VRAI	SI SEULEMENT C ÉTAIT VENU	_
QU EST CE QUE JE SUIS EN TRAIN DE FAIRE	QU EST CE QUE JE SUIS EN TRAIN DE FAIRE MONSIEUR	_
JE VEUX APPORTER QUELQUES PRÉCISIONS	JE VOUDRAIS RAPPELER QUELQUES PRÉCISIONS	_
QUE DE PLUIE	QUE DE PLUS	_
PLUS NOUS MARCHIONS ET PLUS NOUS FATIGUIONS	PLUS NOUS MARCHIONS ET PLUS NOUS FATIGUÉS	_
AUTOUR DE LA PLACE	AUTOUR DE LA PLACE	_
ELLE DORT COMME UN PETIT ANGE VOYEZ	ELLE DORT COMMUNIMENT PIEDRO PAYAIT	_
MONSIEUR A LA COMMUNICATION	MESSIEURS À LA COLONIE	_
IL FAUT CONCLURE MONSIEUR CIOTTI	ILS FONT COMPRENDRE MONSIEUR LE SECRÉTAIRE D ÉTAT	_
LA MAISON A ÉTÉ COMPLÈTEMENT VIDÉE	L AMBASSADEUR A ÉTÉ COMPLÈTEMENT ABSURDE	_
JE REBONDIS SUR UN POINT PARTICULIER	JE VOUS REMERCIE RAPIDE QUE SUR UN POINT ASSEZ PUBLIÉ	_
EH OUI LES TAUX BAISSENT	ET OUI LE PAUVRE BAISSES	_
EST CE QU IL VA PLEUVOIR AUJOURD HUI	EST CE QU IL VA PLEUVOIR AUJOURD HUI	_
OÙ A T IL ÉTÉ	OÙ A T IL ÉTÉ	_
J AI ENTENDU QUE LE TEXAS ÉTAIT BEAU	J AI RENCONTRÉ QUE LE TEXAS ÉTAIT BEAU	_
NE VOUS REGARDEZ PAS COMME ÇA	NE VOUS REG GARÇEZ PAS COMME ÇA	_
TU ES SÛR QU IL AIMAIT	TU ES SÛR QU IL AIMA	_
C EST UNE PETITE DEMOISELLE DIT LE VIEILLARD	C ÉTAIT UNE ACTIVITÉ D ÉMANCIA DES TERRITOIRES	_
MAIS ON NE FAIT PLUS DES HOMMES COMME MOI	MAIS ON NE FAIT PLUS LES DERNIERS COMMANDEMENTS	_
RUE RÉMY ROURE À SAINT PÉRAY	VOS RÉSIDENCES AURONT À SAINT PAYER	_
BONJOUR À TOUS ET À TOUTES	BONJOUR À TOUS C EST ÉTONNANT	_
TU JOUES AU TENNIS	TU JOUES TOUS LES TASSES	_
LE CAFÉ EST VRAIMENT TRÈS CHAUD	LE CAFÉ EST VRAIMENT TRÈS CHAUD	_
IL A VRAIMENT UNE JOLIE FEMME TOUT DE MÊME	LA PAROLE EST À MADAME JACQUELINE FRAYSSE	_
ROUTE DES BONS PRÉS LA CROIX DE LA ROCHETTE	ROUTE DES BONBRAIS LA CROIX DE LA RECHER	_
NANETTE N ÉTAIT GUERE PLUS GRANDE QUE MOI	MAINTENANT ELLE ÉTAIT GARER PLUS GRANDE QUE MOI	_
TU AURAS UN RÉCHAUD DE CHARBON	TU ARAS RAPIDE TOUS LES CHIFFRES DE SOLEIL	_
C EST D UN TRISTE D UNE PLATITUDE DE SOLITUDE	C EST D ATTRETE DU PATRIMOINE LINGUISTIQUE DE CELUI CI	_
AUJOURD HUI C EST DIMANCHE	AUJOURD HUI C EST DIMANCHE	_
QU EST CE QUE VOUS CROYEZ DONC AVOIR SUR LE DOS	QU EST CE QUE VOUS PRENEZ DANS MON CAVEAU SUR LE DOS	_
LA PAROLE EST À MONSIEUR JACQUES LAMBLIN	LA PAROLE EST À MONSIEUR JACQUES KRABAL	_
ILS PARLAIENT À VOIX BASSE	IL PARLAAIT À VOIR BAS BAISSE	_
QU EST CE QUE VOUS VOULEZ VOUS	QU EST CE QUE VOUS VOULEZ VOUS	_
C EST TOUT SAUF NÉGLIGEABLE	C EST QUAND ÇA FONCTIONNE DÉJEUNER	_
S OCCUPER DU TÉLÉPHONE	CE QU IL PUT MIEUX DU TÉLÉPHONE	_
LA PAROLE EST À MONSIEUR LE PREMIER MINISTRE	LA PAROLE EST À MONSIEUR PHILIPPE GOSSELIN	_
TOUS LES COMBIEN DE TEMPS SONT ILS ICI	TOUS LES COMBIEN DE TEMPS DE TEMPS SONT IDENTIQUES	_
C EST LA DISSUASION COLLECTIVE	C EST LA DIFFICILE ICI EN COLLECTIVITÉ	_
VOUS PRENDREZ BIEN UN VERRE DE BIÈRE	VOUS PRENDREZ BIEN ALORS À L ARRÊT DE BUS	_
JE PENSE PAR EXEMPLE AUX CONTENTIEUX AVEC BRUXELLES	JE PENSE PAR L EXEMPLE POUR L EXEMPLE POUR CONTINUER À L ÉCOLE	_
COMBIEN DE TEMPS ÇA PREND EN VOITURE	COMBIEN DE TEMPS DE TEMPS SAINT APPRRE LEURS VOITURES EN VOITURE	_
ON LES DORLOTE CEUX LÀ	ON EST DANS LA TÊTE CELA SUR LÀ	_
JE N AI JAMAIS VU ÇA ENCORE	JE NE L AI JAMAIS VU ÇA ENCORE	_
ÉVARISTE DUMOULIN NOMMA SES COMPAGNONS	ELLES ARRIVENT TRESSAILLIT DU GOUVERNEMENT DANS LA SÉCURITÉ COMPAGNIE	_
RÉAGIS RETOMBE UN PEU SUR TES PIEDS	HÉRICOURT RETOURNANT À PESER SUR LES PIEDS	_
LES FEUILLES LES PLUS LONGUES	LES FAÇAILLES LES PLUS LONGUES	_
L AVENIR C EST À DIRE QUE C EST MAINTENANT	L AVENIR C EST À DIRE QUE C EST D DIRE QUE C EST MAINTENANT	_
RUE ETEX PARIS	CRUEL ÉTAIT EXTRÊMEMENT BELLE	_
AI JE MANGÉ DE LA SALADE	ET JE M EMMÈNERAI DE LA SALADE	_
ELLES ONT AIMÉ	ELLES ONT AIMÉ	_
VOUS ÊTES TOUT POUR MOI	VOUS ÊTES ASSEZ TOUT POUR MOI	_
JE ME SUIS EXPRIMÉE SUR CE POINT	TU ME SUIS ASSISE SUR LE TÉLÉPHONE NE FONCTIONNE PAS	_
CELA NE VOUS A PAS ÉCHAPPÉ	CELA VOUS ÊTES À VOUS FATIGUÉ	_
ENFIN ON A DÛ VOUS VOIR	BONSOIR À TOUS VOS NOUVELLES	_
COMMENT CELUI CI N A T IL PAS PEUR	QUEL EST L AVIS DU GOUVERNEMENT CES AMENDEMENTS IDENTIQUES	_
ILS NE SONT PAS FOUS	ILS NE SONT PAS FOUTUS	_
CETTE CONCEPTION FAIT L UNANIMITÉ AUJOURD HUI	CETTE CONSOMMATION FAIT DU LAIT N EST IDENTIFIÉ AUJOURD HUI	_
ELLE JOUAIT AVEC MOI	ELLE JOUAIT AVEC TOI	_
ELLE APPUIE TROIS FOIS SUR LE BOUTON	ELLE A PLUS TROP FROID TROIS FOIS SUR LE BOUTON	_
MON PANIER AH MOI QUI LE CHERCHAIS	MON PAUVRE AMI AINSI À MOITIÉ LE CHART	_
LA COUR DES COMPTES VOUS L A DIT	LA COUR DES COMPTES VOUS L A DIT	_
VOUS RESSEMBLEZ À MA SŒUR	VOUS RENCONTREZ ABBÉ À LA FEUR	_
C EST DIFFICILE	C EST DIFFICILE	_
LES LIVRES LES PLUS JAUNES	LES LIVRES LES PLUS JAUNES	_
J ACHÈTE LE JOURNAL À LA BOUTIQUE TOUS LES JOURS	J ACHÈTERAI LE JOURNAL À LA BOUTIQUE TOUS LES JOURS TOUS LES JOURS	_
ELLE EST À DÉSESPÉRER DE L OPPOSITION	ELLE EST ASSEZ DÉSESPÉRÉE DE L POSITION	_
LA SUPERFICIE DE L ÎLE EST PETITE	LA SUPERFICIE DE L ÎLE FICE DE L ÉLECTRICITÉ	_
LES ÉCHECS PORTENT BIEN LEUR NOM	LES HÉSITIFS POUR PEU BIEN LEUR NON	_
UNE BELLE FLEUR	UNE BELLES FEUILLES FURENT	_
MES VOISINS SONT TRÈS BRUYANTS	LES BRAS FARCES SONT TRÈS PRISONNENT	_
QU EST CE QUE TU ES EN TRAIN DE FAIRE	QU EST CE QUE TU ES EN TRAIN DE FAIRE	_
ROUTE DU MEYNAT À LA CHAPELLE DE LA TOUR	ROUTE DU MÉLIN À LA CHAPELLE DE LA TOUR	_
CE SERA FAIT MESSIRE	CE SERA FAIT LE SIEN	_
MARIUS CACHA LES PISTOLETS DANS SES GOUSSETS	MARIUS S ÉTAIT CASSÉE LA LE PISTOLET DANS SES COUSSINS	_
UNE CHOSE ENCORE	UNE JUPE NOIRE	_
HÉLAS JE N AI PLUS QUE VOUS	ET LÀ JE NE PUIS PLUS QUE VOUS	_
MONSIEUR DE CRILLON L A DIT SOUVENT EN MA PRÉSENCE	MONSIEUR LE PRÉSIDENT LA DIFFICULTÉ À MA PRÉAISANCE	_
LEUR NIVEAU DE PROTECTION SOCIALE EST TRÈS HAUT	LEURS NOUVELLES DE PROTECTION SOCIALE SOCIALE À L ÉTRANGER	_
TOUT EST PRÊT	TOUTES LES PAUVRES	_
LES VOILÀ CES ARCHITECTES	IL VOULLA À SES ARCHITES TÊTE	_
RUE GÉNÉRAL GAULARD À BELFORT	RUE GENEVIÈVE BOLLANETTE À BELFORT FORT	_
EST CE QU IL TRAVAILLE BIEN	EST CE QU IL TRAVAILLE BIEN	_
NOUS RESTONS LIRE TANT QU IL Y A DE LA LUMIÈRE	NOUS RESTERONS MIRONS TROMPER TANT QU IL Y A DE LA LUMIÈRE	_
SEIZE RUE FORTUNÉ CANTECOR	SEIZE RUE FORTIGÉ CANDERY CONCOURT	_
C EST MADAME GICLEFORT QUI EST L AÎNÉE	C EST MADEMOISELLE CLAIRE J AI QUE FORT QU IL LUI	_
QUE TA FORTUNE ÉTAIT FAITE	TOUT D ABORD IL HABITE UNE DÉFACCE	_
EUX ILS AIMERONT	EUX ILS EURENT AIMÉ	_
LE PLUS ÂGÉ DES ÉLUS	L ONCLE EDME ET ÉVIDEMMENT	_
FAÑCH S OCCUPE DES BÊTES	FRANCHEMENT SUR CE CURÉ DES BÊTISES	_
LA PAROLE EST À MADAME MARIE GUÉVENOUX	LA PAROLE EST À MADAME ANNIE GENEVARD RAYMOND	_
OÙ EST LE VULNÉRAIRE	OH ELLE EST L UTILISATION	_
ÇA C EST UNE ANALYSE	ÇA C EST UNE VÉRITABLE IDÉE	_
JE VAIS VOUS CHERCHER DES LUNETTES	JE VAIS VOUS CHERCHER DES MÉDICAMENTS	_
LE PÈRE DE YANN EST MON ONCLE	LE TARD DES ASSASSINS DE MON MAIN UNE PIÈCE	_
C ÉTAIT LA PENSÉE DE CATHERINE	C ÉTAIT LÀ PAPIER LA PENSÉE DES QUARTIERS	_
REVENONS AU CAS DE LA MÉTROPOLE LYONNAISE	REVENANT AUX CADRES DE LA MÉTHODE DE LA MÉTROPOLE L ÉGLISEE	_
LA COMMISSION A DONNÉ UN AVIS FAVORABLE	LA COMMISSION A DONNÉ UN AVIS FAVORABLE	_
TOUT LE MONDE S OCCUPE DE TOUT EN MATIÈRE DE TOURISME	TOUT LE MONDE SE TUT LUI D ÉTU À LA CŒUR À LA CIRCULAIRE UTILISATION	_
JE SUIS DE POISSY	JE SUIS DE POICI	_
SEULES DES PERSONNES MAJEURES PEUVENT ÊTRE ADMISES	CELLE DES PERSONNES DÉ PERSONNELLES MAJEURES PEUVENT ÊTRE ADMISES	_
TU POURRAIS ME PARLER DE SYLVIE	TU POUVAIS ME PARLER MA PARLER DE SUPPRIMER	_
LE MARDI FATAL ARRIVA BIEN VITE	LE MARQUIS HÂTA ELLE A À TÊTE À L INITIAT À GAUCHE	_
CELA SERA STRICTEMENT IMPOSSIBLE	CELA SERA EXTRÊMEMENT POUSSIBLE	_
RUE DES SCAFIGNOUS À PUY L ÉVÊQUE	RUE DES FRÈRES FIGURES À PUY L ÉVÊQUE	_
VINGT SEPT C ROUTE DES PRÉS	VINGT SEPT ADULTES ROUTE DES PRIES	_
ET COMMENT TU T APPELLES	IL COMMENT MAINTENANT TU T HABILLES	_
C EST POURQUOI NOUS SOUTIENDRONS CETTE MESURE	C EST POURQUOI MES COLLÈGUES NOUS SOUKIONS À DÎNER CETTE MESURE	_
ON NE VA PAS TARDER À ALLER MANGER	ON NE VEUT PAS ACCORDER À PART ET À L ÉMOCHERÉ	_
ELLE AIMAIT TA SŒUR	ELLE AIMAIT TA SŒUR	_
ILS NE L AVAIENT PEUT ÊTRE PAS REPÉRÉ	ILS NE L AVAIENT PAS EXTRÊMEMENT PIEDS	_
SA VOLONTÉ RÉGIT LA TERRE COMME LE CIEL	SA VOIX MON ÉTERNAIT RÉJOUIT LA TÊTE COMME MICHELINE	_
FAITES EXCUSE MONSIEUR ELLE N Y EST PAS	CETTE ESPÈCE EST ESPUIS MONSIEUR ELLE N Y EST PAS	_
VOUS VOILÀ DONC MORALEMENT ASSOCIÉ MONSIEUR HUYGHE	VOILÀ D AUTRES AMENDEMENTS IDENTIQUES AMENDEMENTS IDENTIQUES	_
IL PARAIT QUE C EST TOUS LES ANS	IL PARAÎT QUE C EST TOUT QUE C EST TOUS LES ANS	_
ON ATTENDAIT SA PAROLE	ON ENTENDAIT DES SYNDICATS À PARIS	_
ILS S ENTRAIDAIENT BEAUCOUP L UN L AUTRE	IL SENTIT D ÉLAGUER LES COUSSINS DE L AUTRE	_
QUELLE EST VOTRE ADRESSE	QU IL EST VOTRE DRESSER	_
QUATRE CENT TRENTE TROIS ROUTE DE BOISSEY	QUATRE CENT TRENTE TROIS ROUTE DE BOIS	_
ON NOUS A REFUSÉ L ENTRÉE DES PRISONS	NOUS NOUS AVONS FUSSÉ L ENTRÉE DES PRISONNIERS	_
J AI ACHETÉ DES POMMES ET J EN AI MANGÉ UNE	J AI ACHETÉ DES POMMES ET J EN AI MANGÉ UNE	_
ENTENDEZ LA VOIX DES TRAVAILLEURS	ON T EN DONNE LA VOIE DU TRAVAIL	_
JE VOUS SUGGÈRE DE RETIRER VOTRE AMENDEMENT	JE VOUS SUGGÈRE DE RETIRER VOTRE VÉRITÉ VOTRE AMENDEMENT	_
LE PREMIER A TRAIT AU PROGRAMME DES INVESTISSEMENTS D AVENIR	LE PREMIER ACTRAIT EST TRÈS AUX PROFESSIONNELS DES INVESTISSEMENTS D ADMINISTRATION	_
QUE CE QU ELLE SAIT BIEN	QUE EUX SOIT ELLE C EST BIEN LÀ	_
UN PAGE TROIS CENT CINQUANTE DEUX	POUR QU IL PÊCHE TROIS CENT CINQUANTE DEUX	_
VOUS AVIEZ LE TEMPS DE VOUS Y PRÉPARER	VOUS AVIEZ LE TEMPS DE TABLE DE VOUS INQUIÉTUDE	_
JE LEUR AI DONNÉ QUARANTE SOUS ET UN VERRE DE VIN	JE LE RÉGÈNE DANS L ÉGLISE DE SON ET UN VERRE D EAU	_
VA NOUS CHERCHER DE LA BIÈRE	VA NOUS CHERCHAIT DE LA LIBERTÉ	_
JE VEUX VOUS POSER UNE QUESTION	JE VEUX VOUS PRÉSENTER UNE QUESTION	_
MAIS IL NE S AGIT PAS DE CELA	MAIS IL NE S AGIT PAS DE CELA	_
ELLE ALLAIT À L ÉCOLE SANS SE PRESSER	ELLE ALLAIT À L ÉCOLE SANS SE PRESSER	_
JE NE PEUX PAS	JE NE PEUX PAS	_
QU EST CE QUE VOUS PRENEZ POUR LE DÉJEUNER	QU EST CE QUE VOUS PRENDREZ POUR LE DÉJEUNER	_
ÇA FAIT LONGTEMPS QUE JE NE L AVAIS PAS VUE	CE FUT FAIT LONGTEMPS QUE JE NE L AVAIS PAS VU	_
C EST UNE EXCELLENTE NOUVELLE	C EST UNE EXCELLENTE	_
POURTANT ON CONTINUERA DE TRAVAILLER	POURTANT ON CONTINUERA DE TRAVAILLER	_
NOUS IRONS AU CINÉMA S IL PLEUT	NOUS Y IRONS AU CINÉMA S IL PLEUT	_
CONDUIS MONSIEUR AU COMBLE DIT IL	CONDUIT MONSIEUR LE COMPROMIS	_
NOUS VERRONS BIEN CE QU IL EN SERA	NOUS VERRONS BIEN CE QU IL N EN SERA	_
FAUT IL LE PRÉVENIR QUE MADAME EST LÀ	FAUT IL LE PRÉVENIR ÇA MAINTENANT MADEMOISELLE	_
JE NE POURRAI RIEN FAIRE AVEC SI PEU D ARGENT	JE NE POURRAI RIEN FAIRE ARRÊTER À L EXPÉRIMENTATION	_
PAR L INNOVATION	PAR AMOUR DIT NOUVEAU	_
MON DIEU JE N AI RIEN	MON DIEU JE LUI VIENDRAI	_
MON PÈRE EST AVOCAT	UNE PAIRE L HERBE EST AVOCAT	_
UN MOT AVAIT CALMÉ LES FLOTS	ALLONS AVEC VÉRITABLE MÉNAGE LES FLOTS	_
CHEMIN DU MARQUIS AU NUMÉRO VINGT SEPT	CHEMIN DU MARQUIS DU MARQUIY AU NUMÉRO VINGT SEPT	_
FAITES DONC QUELQUES HEURES SUPPLÉMENTAIRES	FAITES DONC JE DONC QUELQUES UNS SUPPLÉMENTAIRES	_
OUI JE VIENDRAI	OUI JE VIENDRAI LUNR	_
NOUS RIONS NOUS BUVONS	NOS RÉGIONS VOUS PRIEZ VOUS	_
ILS EN FURENT BIEN PUNIS	VOUS OCCUPER AU DÉJEUNER	_
IL Y A PARADIS ET PARADIS	IL Y A PAS LÀ DEDANS ET ÉPARGNER	_
VOUS COMPROMETTEZ VOS SUCCÈS	VOUS COMPROMENEZ QUE VOUS ÊTES VOUS SUCCÈS	_
NOUS AVONS ENCORE LE TEMPS	NOUS AVONS ENCOURAGEMENT ENCORE LE TEMPS	_
IL EXIGE QU IL PAYE	IL EXISTE JE TIENS QU IL PAYE	_
JE SUIS VENU TE VOIR	JE SUIS VENU VOUS VOIR	_
JEAN A L ÉTAT	JEAN AVEZ PASSA	_
ET PUIS TU M ENNUIES	ET TU ES TU M ENNUIES	_
QUARANTE TROIS AVENUE DES LIONS	QUARANTE DEUX TROIS À VENDRE DES LIENS	_
VOUS SAVEZ COMBIEN ELLE COÛTE	VOUS SAVEZ COMBIEN IL COÛTE	_
QU EST CE QU ELLE VOUS A DEMANDÉ	QU EST CE QU ELLE VOUS A DEMANDÉ	_
VOUS POUVEZ LE REDIRE S IL VOUS PLAIT	VOS COLLÈGUES ÉLÈVES LA VICTIME SI VOUS PLAÎT	_
LES MONNAIES VIRTUELLES EFFRAIENT LES GOUVERNEMENTS	LES AMENDEMENTS IDENTIQUES ET FRÉÉES LES CÔTÉS	_
ÇA M A COÛTÉ CHER	ÇA M A COÛTÉ CHER	_
RUE DE LA FABRIQUE AU NUMÉRO HUIT	PLUS QUE LA FENÊTRE AU MILIEU DU NOUVEAU	_
VOUS AVEZ LÀ UNE BIEN MAUVAISE TOUX	VOUS AVEZ LÀ UNE GLACE IMPOSSIBLE	_
J Y AI MÊME GAGNÉ CINQ LOUIS CE QUI M A FAIT PLAISIR	J AI UN MÊME GÉNÉREUX DE SA CLOU OUI CE QU IL NE FAISAIT PLAISIR	_
CAR IL EST MORT PAR VOTRE FAUTE	QUEL EST L AVIS DU GOUVERNEMENT FAVORABLE	_
EST CE QUE LES CHÂTELAINS VIVENT LÀ À L ANNÉE	EST CE QUE JE L AI ÉCHAPPÉ EN VIVANTS À L ANNÉE	_
EXPÉDIAIT EST BIEN LE MOT	EXPLIQUEZ DIRE ET BIEN LE MOMENT	_
VINGT TROIS GARS	VINGT TROIS ÉLÉPHANTS	_
JE SUIS EN TRAIN D ÉCOUTER	JE SUIS TRÈS EN TRAIN D ÉCOUTER	_
COMME C EST BIEN PRÉSENTÉ	COMME C EST BIEN PRÉVENTANTÉE	_
QUI L ACCOMPAGNAIT CE JOUR LÀ	QUI L ACCOMPAGNAIT CE JOUR LÀ	_
UNE BOUQUETIÈRE VOULAIT LUI PRÉSENTER UN BOUQUET	LE BOCTIER VEUT ARRÊTER DE PRÉSENTER UN COUP À BOUQUET	_
LA PAROLE EST À MONSIEUR JÉRÔME NURY	LA PAROLE EST À MONSIEUR GÉRARD CHERPION	_
MERCI MON AMI MERCI	MERCI MADAME LA MINISTRE MARSEILLE	_
LES LAQUAIS S INCLINÈRENT ET L ON PASSA	LES LAQUAIS SACRILES FATIGNAIRE ET LEURS PASSENT	_
NON MONSIEUR C EST POUR UNE ROBE	NON MONSIEUR C EST POUR UNE GRANDE BABLE	_
COMMENT ÇA SE DIT EN ANGLAIS	COMMENT S ASSOIT DE DIRE EN ANGLAIS EN ANGLAIS	_
CAR ENFIN IL S EST DÉRANGÉ CET HOMME	CAR ENFIN AUX FEMMES SE DÉRANGERAIENT SOUS LES TONNEAUX	_
S ILS PÊCHAIENT	SI IL PÊCHAIT	_
OÙ ALLEZ VOUS	OÙ VOULEZ VOUS L ÉPOUX	_
JEAN À PART UN GRIPPE SOUS	JEAN ATTRAPER APPART APRÈS UN BIBICHON	_
ELLES PIAFFAIENT DANS LE RUISSEAU LE LONG DU QUAI	APPLAUDISSEMENTS SUR LES BANCS DU GROUPE SRC LE LONG	_
À QUELLE DISTANCE EST IL	À QUELLE DISTANCE COMMEANCE TÉLÉPHONE	_
QU ILS SOIENT MAUDITS SI CE N EST PAS VRAI	QU ILS SOIENT MAUDITS SI CE N EST PAS VRAI	_
CE BUDGET EST VERTUEUX	CE BUDGET EST ERREUR	_
D UN MARDI À UN MERCREDI	D OÙ MADAME MADEMOISELLE EMMEL MADEMOISELLE	_
HUIT RUE LAHIRE	HUIT RUE DE L AMIRAL	_
CETTE COHÉRENCE S APPUIE DÉJÀ SUR DES OUTILS	CETTE COLONNE FUT LONGTEMPS SA PLUS DÉJÀ SUR DÉJEUNER	_
ALORS POURQUOI M AVIEZ VOUS TÉLÉPHONÉ	ALORS POURQUOI M AVEZ VOUS RÉVEILLÉ VOTRE ÉLÉPHÉ	_
MONSIEUR MADEMOISELLE MADAME	AUSSI À MA MADEMOISELLE MADAME MADEMOISELLE MADAME	_
LE DOMESTIQUE SE SAUVE À DROITE	LE DOSSIER SE SOUMET À DROITE	_
LA PAROLE EST À MONSIEUR FRANCK RIESTER	LA PAROLE EST À MONSIEUR FRANÇOIS PUPPONI	_
OH LA SOCIÉTÉ LA SOCIÉTÉ	OÙ EST LA SOCIÉTÉ ET LA SOCIÉTÉ	_
UN FEU DE SALVE DÉCHIRA L AIR	ENFOU DERNIER DE SA RÉFÉRENCE AU DÉCHARGE ARGUMENTAIRE	_
JE NE L ACCEPTERAI JAMAIS	JE NE L ACHÈTERAI PAS RÉGIME	_
RUE DE LA FOSSE BERNARD AU NUMÉRO SOIXANTE SEPT	RUE DE LA FOSSE BERNARD BERNARD AU NUMÉRO SOIXANTE SEPT	_
MONSIEUR DE CHARNY SE LEVA D UN BOND	MONSIEUR DE CHARNY S ARNIGNEMENT C EST LONGTEMPS	_
AH C EST QUE C EST UN TEL GAILLARD	AH C EST QUE C ÉTAIT UN TEL GÉRARD	_
JE T Y EMMÈNERAI UN JOUR	JE VIENDRAI LUNDI À LA JAMBE	_
COMÉDIE MURMURA T IL	COMBIEN Y ÊTES MURMURA T IL	_
VIENS EMBRASSER MAMAN SABOULEUX	TIENS EN PREMIÈRE PRA CES MAMANS SABOULEUX C EST BEAU	_
VINT QUATRE CHAISES NOIRES	VINGT QUATRE CHAISES NOIRES	_
JE NE FAIS DE PHRASES J ÉLÈVE LES IDÉES DE L ENFANT	JE M EFFORCE DE FARCE JE L AI ESSAYÉ DE L INFORMATION	_
TIENS GARDE MOI MON PANAMA	TIENS BIEN DEMAIN NOUS PÊCHERONS	_
ROUTE DE GARTEMPE AU NUMÉRO DEUX	ROUTE DU GARENTON AU NUMÉRO DEUX	_
VOILÀ MES CHERS COLLÈGUES LES ÉLÉMENTS QUE JE VOULAIS VOUS DONNER	VOILÀ MES CHERS COLLÈGUES CLAIREALES LES ANNÉES QUE JE VOULAIS VOUS DEMANDER	_
DANS TON GENOU	D ENTENDRE JAUNES	_
RUE GABRIELLE MASSOT À VEYNES	RUE GABRIEL MASCOURT À MARSEILLE	_
IL N EST PAS EN TRAIN D OUVRIR LA PORTE	N EST PAS EN TRAIN D OUVRIR LA PORTE	_
SI TOUT LE MONDE ME DONNAIT UN CENTIME JE SERAIS RICHE	C EST TON TOUR QUE MADEMOISELLE DE LA SANTÉ PUBLIQUE JUSQU IRAI	_
VINGT NEUF RUE GÉNÉRAL BOTHA	VINGT NEUF RUE DU GÉNÉRAL DE GAULLE BOTAINS	_
IL N Y A RIEN QUE DU BEAU MONDE ICI	IL Y AVAIT UNE BIBLIOTHÈQUE AUSSI	_
LES HOMMES JOUAIENT À LA BOURSE	LES ENFANTS NE JOUAIENT À LA BOURSE	_
J ENTENDIS ALORS DE NOMBREUSES PLAINTES	J EN FONT DIT À L ORDRE DE NOMBREUSES CLASSIQUES	_
COMMENT MAIS QU EST CE QUE JE SUIS DONC ALORS	COMMENT OÙ ESTES CE QUE JE SUIS DANS LE GRENIER	_
DE PLUS EN PLUS DE GENS LE FONT	DE PLUS EN PLUS DE GENS DE FONCTIONNAIRES	_
OÙ VAS TU	OÙ VAS TU	_
VACANCES DE FÉVRIER PÂQUES ET ÉTÉ	VOTONS DES FEUILLES DE FEUILLÉES PAR ELLES IDENTIQUES	_
ELLES AVAIENT L ŒIL SUR TOUT ET TOUT LE MONDE	ELLES AVAIENT L AIR SURTOUT ET SURTOUT LES TONNES	_
SI NOUS POUVONS LES NIER	SI NOUS POUVIONS LES MIEUX	_
À L AUTRE MAINTENANT	ALLONS VOTRE AMENDEMENT N EST PAS LÀ	_
VOUS AVEZ CITÉ LES CINQ PREMIERS	VOUS AVEZ ESSAYÉ L EXAMEN DES FEMMES TRAÎNÉÉES	_
OUI ON ME VERRA	VOYONS NE GRANN PAS	_
IL EST PLUS ÂGÉ QUE MOI	IL N EST PLUS AJOUTEZ QUE MOI	_
ALORS JE DEMANDE UNE SUSPENSION DE SÉANCE	ALORS LE DERNIER DE MADAME DE SUPPRESSION DE SÉANCE	_
HIER IL M A PARU VOUS REGARDER AVEC DES YEUX SOUPÇONNEUX	IL N Y A AUCUN CRAYON DANS MA BOÎTE DE DÉJEUNER LE DÉJEUNER CE SONNE	_
JE VOUS PROPOSE DEUX CHOSES	DEPUIS QUELQUE TEMPS DE JOUER	_
EH BIEN SOYONS TERRIBLES FAISONS LA GUERRE EN LIENS	EH BIEN FIT LE PROBLÈME POURRIE DE LA GUERRE À LA GUERRE VIENT	_
UNE TERRASSE DU PALAIS BARBARIGO À VENISE	NOUS DEVONS SYSTÈMES DU PALAIS BAR BARBE BLEUE D ORGANISER DES NYMPHES	_
J AI VU LE CHIEN TRAVERSANT LA ROUTE	J AI VU LE CHIEN TRAVERSANT LA ROUTE	_
C EST POURQUOI JE VOTERAI CONTRE L AMENDEMENT DU GOUVERNEMENT	C EST POURQUOI JE VOTERAI TRÈS CONTRAIRE À L AMENDEMENT DU GOUVERNEMENT DU GOUVERNEMENT	_
JE PARLAIS DES DÉFICITS STRUCTURELS	JE PARLERAI DES DÉFICITS FUT CES FRUITS FUTURAIENT LÀ	_
GROS ET DÉTAIL	GRONDE ET LES DÉTAILS	_
RUE BOUVET COCONI AU NUMÉRO UN	RUE BOURRY CONCOURT À NIORT	_
QUE VOULEZ VOUS FAIRE	QUE VOULEZ VOUS FAIRE	_
OUI MAIS PLUS MAINTENANT	OUI MAIS C EST PLUS LONGTEMPS	_
JE SUIS TOMBÉ DANS LES ESCALIERS	JE SUIS SAISI DE DEUX AMENDEMENTS IDENTIQUES	_
LE PLUS LONG	LE PLUS LENT	_
SES DENTS CLAQUÈRENT D ANGOISSE	C EST DONC LÀ QUE LA KORIGANE	_
C EST UNE QUESTION D HONNEUR	CELLE NOUS CASSONS DE NORRIÈRES	_
UN FRISSON PASSA DANS L AIR	UN FRISSON PAS ÇA DANS L AIR	_
C ÉTAIT UNE TRUIE AVEC LE REGARD D UNE TIGRESSE	C ÉTAIT UNE TRUCRÉTION AVEC LE REGARD DU TERRITOIRE	_
MA SŒUR EST FORT CONTENTE DE SES VENDANGES	LA SCÈNE SE PASSE À AUTANT QUE C EST D ENGAGE	_
EH BIEN VOUS POUVEZ VOUS LE FIGURER	EH BIEN VOUS POUEZEZ VOUS DE FIORER	_
ELLE JOUAIT AVEC NOUS	ELLE JOUAIT AVEC NOUS	_
LES FRAYEURS DE SON MARI L ÉCŒURAIENT	LES FRANÇAIS NE SONT PAS RÉALISÉES À L ÉCOLE	_
TÊTE ET COEUR PAR ALFRED DE MUSSET	QUELLE EST LA TERREUR PARE FRANÇAIS DÉMISSAIT	_
J AI FAIT UNE ERREUR	J AI FAIT UNE ERREUR	_
C EST LE CAS	C EST LE CAS	_
JE SERAI BREF MONSIEUR LE PRÉSIDENT	JE SOUHAITE RÉPONDRE MONSIEUR LE PRÉSIDENT	_
MON ORDI A BEAUCOUP DE MÉMOIRE	MON ARGUMENTEZ À VOS COUPS DE MÉMOIRE	_
ILS ÉTAIENT TOUS SORTIS EN MÊME TEMPS DE LEURS GALERIES	LES ÉTABLISSEMENTS SURTIRENT AUTOUR DE LEURS DE LEURS GUERRES	_
IL VIENT LUI MÊME CONVAINCRE JUDITH	IL Y A EU UNE MAUVAISE MADEMOISELLE CLAIRE JUDITH	_
JE CROYAIS AVOIR COMPRIS CHERS COLLÈGUES	JE PRENDRAI UN VERRE D EAU S IL VOUS PLAIT	_
VOICI VOTRE CRAVATE MONSIEUR	VOICI VOTRE VOTRE CRAVATE MONSIEUR MONSIEUR	_
LE ROI A DIT QUE C ÉTAIT BIEN RÉPONDIT DE LYONNE	LE ROI DIT QUE C ÉTAIT B BIEN RÉPONDRE RÉPONDIT DE LUI MÊME	_
TROIS RUE DU DECAU	TROIS RUE DU DEUX CLOS	_
COMBIEN ÇA COÛTE	CROYEZ ÇA C EST COUP	_
EH BIEN COMMENCES TU À T HABITUER UN PEU À MONSIEUR GARGARET TON PRÉTENDU	ELLE BIEN A COMMENCÉ À COMMUNIQUER AVEC LUI LE SECRÉTAIRE D ÉTAT EST CONTRARIÉ	_
UN PANTALON BEAUCOUP TROP GRAND	APPLAUDISSEMENTS SUR LES BANCS DU GROUPE REM	_
J AI ENVIE D ACHETER QUELQUE CHOSE	J AI ENVIE D ACHETÉS CE PETIT QUELQUES CHAUSSURES	_
CE N EST PAS BON	CE N EST PAS VOUS	_
UN BILLET ALLER RETOUR	ON EÛT DIT A LEUR TORT	_
LE GAMIN REMONTAIT	LE GARÇONEMENT REMONTÉAIT	_
DESCENDANT VERS SON MARI	ET SANS DOUTE BERNARD SON MARI	_
RUE LOUIS OLLIER VALENCE	RUE LOUIS HOLUIL À VALENCE	_
C EST DONC LA CHRONOLOGIE DU BON SENS	C EST EN QUE LA PREMIÈRE PREMIÈRE RÉUNION S ANNONCE	_
CHEMIN DU SOURBIER CHAMPIS	CHEMIN DES SERGIES CHAUMONT	_
IL ÉTAIT LOIN ENCORE DE CES DISPOSITIONS	IL EST ÉGALEMENT ENCORE DE CE DISPOSITIF	_
LOTISSEMENT ISABELLE ORAISON	LOTISSEMENT LES ALBIDES À BELLES ROSES	_
TU ME TÉLÉPHONES SI TU AS BESOIN	TU NE T ATTAQUES PAS LES FEMMES SUIVANTS	_
IL SE REGARDE DANS LA GLACE À DROITE	NOUS SERONS RENTRÉES DANS LA GLACE À DROITE	_
IL EST PRIS LE CRÉSUS C EST TOUT COMME	IL EST PRIE LE PRÉSIDENT C EST JUSTE C EST TOUT COUTEAU	_
CE N EST PAS L ÉGALITÉ	CE N EST PAS LÉGALITÉ	_
IL EST TEMPS DE REMÉDIER À CETTE ANOMALIE	IL EST TEMPS DE RÉ MÊMEGIR À CET ANIMAL	_
MA MÈRE ME FAIT PERDRE L ESPRIT	MA MÈRE ME FAIT TERRE DANS L ESPRIT	_
C EST MOI	C EST MOI	_
MOI POUR QUOI FAIRE	MOI QU ON PÊCHAIT	_
COMBIEN Y EN A T IL	COMBIEN Y A IL HABITUEL	_
ELLE TRANQUILISA SA MÈRE EN LUI TÉLÉPHONANT	POUR TOUTES CES RAISONS NOUS SOMMES D ACCORD POUR NOTRE AMENDEMENTS IDENTIQUES	_
OÙ JE VAIS RETROUVER MON ENFANT	OH JE NE L AI RENCONTRÉE À MON ENFANTF	_
C EST DONC UN AVIS FAVORABLE	C EST DONC QUE L AVIS EST FAVORABLE	_
MAIS MADAME BICHU JE VOUS EN PRIE	MAIS MADAME BICHU JE VOUS EMMÈNE JE VOUS EN PRIE	_
DÉCRET DU GOUVERNEMENT PROVISOIRE PARLÉ	DES CRÉDITS DE COUDRALEMENT PROVISOIREMENT PROVISOIREMENT PARLER	_
MADAME GAUDIN LA PROBITÉ	MADAME GAUDIN C EST LA PREMIÈRE FOIS	_
COMBIEN D ARGENT AVEZ VOUS SUR VOUS	COMBIEN D ARGENT AVEZ VOUS SUR VOUS	_
À REVOIR MADEMOISELLE PAMÉLA	EN REVANCHE MADEMOISELLE PAULINE PAYSANS	_
À LUI S ADRESSAIT LA MALÉDICTION DE CETTE MÈRE INFORTUNÉE	APPLAUDISSEMENTS SUR LES BANCS DU GROUPE FI LA PAROLE EST À MONSIEUR PATRICK HETZEL	_
JE LE REMPLACE	JE LE REGRETTE	_
MAIS CE QUE VOUS FAITES NE SERA PAS INDOLORE	MAIS CE QUE VOUS FAITES NE SE RAPPELLENT RIEN DE LEUR	_
AH JE SUIS CONTRARIÉE	FRANÇOIS JE SUIS CONTRARIÉ	_
ONZE ROUTE DE LÉDIGNAN	ON SE RETROUVAIT ÉGALEMENT	_
LA BELLE FILLE DE LE GALL	LA PAILLE LUI FIT DE LE GÂTEAU	_
ONZE RUE LOUIS ALBERT DEMANGEON	ONZE RUE LOUIS À LIÈREERMONT	_
MAIS PUISQUE JE NE VOUS AIME QUE QUAND VOUS N Y ÊTES PAS	MAIS PUISQUE JE NE VOUS AIME PLUS QUE VOUS VOULEZ PAS	_
ILS ONT L HABITUDE DE TRAVAILLER DE CETTE MANIÈRE	ILS ONT L HABITUDE D UTILISER DE TRAVERSER DE CET HÉMICYCLE	_
ALLÉE AMÉLIE MURAT PONT DU CHÂTEAU	ALLEZ À MES ÉLÉMENTS DU RAPPORTEUR EN DU CHATEAU	_
ET UN F N	ET ONZE ELLES ELLES AIMAIENT	_
ROUTE DE TAUZUC SAINT SAUVEUR DE MONTAGUT	ROUTE DE D OZIE SAINT SAUVEUR DE LA TABLE	_
CHAOS C EST UN PEU FORT	CARLOS C EST UN PEU FORT	_
GENS DE LA NOCE	JEAN DE LA NOSSE	_
COMBIEN ÇA VOUS A COÛTÉ	PRENEZ UNE SAINTE À VOTRE ÂGE A CÔTÉ	_
CHEMIN DU TANDENET AU NUMÉRO QUINZE	CHEMIN DU TANT DONNAIT AU NUMÉRO QUINZE	_
J ENTRE DANS SON CABINET D ÉTUDE	CHANTE D ENSEMBLE DANS SON CABINET DES CUITES	_
SA RÉPONSE TOUT AUSSI EXPLICITE A PERMIS DE LEVER LE GAGE	SA RÉFLEXION PARTOUT SOUS LES PHILOSOPHIQUES APERMISES DE LE VESTIBULE	_
DANSEZ NOUS VERRONS BIEN	DANS FAIT LE RÉPUBLICAIN	_
ON RIGOLAIT BIEN PARFOIS	ON RÉPONDIT DANS LA BIBLIOTHÈQUEMENT	_
JE DEMANDE DONC MOI AUSSI SON RETRAIT	JE DEMANDE DONC L ENLÈQUEMENT AUSSI SANS RETRAITE SANS RETRAITE	_
IL EST VENU ICI TOUT SEUL	IL EST VENU VENIR ICI TOUT SEUL	_
J ESPÈRE QU ILS SERONT VAINQUEURS	QU EST CE QU ELLES SONT EN TRAIN DE PARLER	_
MONSIEUR NE VA PAS TARDER À SONNER	MONSIEUR NE VA PAS À TA SŒUR	_
UNE RÉFORME PROFONDE EST NÉCESSAIRE	UNE RÉFLEXION PRONONCÈRENT DES MESSIEURS FORT ARROGÉES	_
MON PETIT CHARLES	MON PETIT PAPIER CHARLES	_
CHEMIN DE CASTELVERT LAVAUR	CHEMIN DE CASTELNAUVE L ABORDE LA BOURG	_
DANS MA TÊTE	DRÔLE DE TÊTE	_
IL EST TEMPS DE PARTIR	IL VA ÊTRE TEMPS DE PARTIR	_
TU ES SÛR QU ELLE AIMAIT	TU ES SÛR QU ELLE AIMA	_
EST CE QU IL PEUT PARLER À MLLE SMITH SIL VOUS PLAIT	EST CE QU IL PEUT PARLER À MADEMOISELLE EMMEL MADEMOISELLE SMITH S IL VOUS PLAIT	_
SI JE PEUX TÉLÉPHONER JE LUI DIRAI TOUT DE SUITE	SI JE PEUX TÉLÉPHONER LES FENÊTRES JE LUI DIRAI TOUT DE SUITE	_
SOURIRES TRÈS BIEN JE VOUS REMERCIE	TRÈS BIEN JE VOUS REMERCIE	_
CELA ME SEMBLE TRÈS UTILE	CELA ME SEMBLE ESSENTIEL	_
AUSSITÔT L ON FIT VOLTE FACE	OÙ L ONCLE EFFERA LE TAPIS	_
JE NE TE SENS PAS	JE NE TE SOMME PAS	_
TOUT LE MONDE S EN FOUTRAIT	TOUS NOUS SOMMES FOUTRAIENT	_
TOUT SE SUCCÉDA SELON SES VOEUX	TOUT CE SUJET SES D ACCORD S IL VOUS PLAIT	_
C EST L ESSENTIEL	C EST LES SENSIELLES	_
IL EN ÉTAIT AINSI PARCE QUE J AVAIS SIX ANS	IL EN ÉTAIT AINSI À CE QUE JE LE SUISSE	_
LE PROJET EST ABANDONNÉ	LE PROJET NI EST EST ABANDONNÉ	_
COMMENT SAVEZ VOUS ÇA	COMMENT S APPELLE VOTRE SŒUR	_
LE NOUVEAU SQUARE MARIN FAIT LE BONHEUR DES ENFANTS	LE DOIGT SCOURT À MAR ARRANGE C EST LE BONHEUR DES ENFANTS	_
JE SERAI DEHORS LE MOINS LONGTEMPS POSSIBLE	JE SAURAI D AILLEURS LE MOIS D ENTRE EUX POSSIBLE	_
ELLE A PRIÉ POUR VOTRE BONHEUR	ELLE A PRIS POUR PAYER POUR VOTRE BONHEUR	_
ET IL S ÉTONNAIT QUE SA MÈRE EÛT RAISON PAR LE FAIT	ET IL FAIT DONNÉ QU IL NE SAVAIT QUE FAIRE UNE RÉVOLUTION PAR LE FAIRE	_
ELLE ÉTAIT MORTE D INQUIÉTUDE	ELLE ÉTAIT MORTE D INQUIÉTUDE	_
DES PROFESSEURS DE BRETON	MAIS PROFESSEUR DE BRETON	_
MAIS SUIS JE SEUL AU MONDE	MAIS SI JE SAVAIS MON MONDE	_
L HOMME DU BOUTE FEU S AVANÇA	L AMOUR DU PROFOSSE S AVANÇA	_
QUARANTE QUATRE RUE DE LA CLEF	QUARANTE QUATRE RUE DE LA CLÉIE	_
LA TONALITÉ NE TROMPE PERSONNE PAS PLUS QUE LE CONTENU	LA TENDANCE EST LE TRÔNE DE TROMPETTE À PLUTÔT QUE LE CANTONNIER	_
JE VOUS DOIS LA VÉRITÉ	JE VOUS DONNE LA VÉRITÉ	_
AUSSI FATIGUÉ QUE TOI	AUSSI FATIGUÉE DE TOI	_
UN MOMENT NOUS N AVONS PAS DE CUISINIÈRE	EMMENEZ MOI DONC N AVEZ VOUS PAS CRÉÉ LÉGÈRES	_
C EST LE DROIT D INVENTAIRE DE MONSIEUR MARITON	C EST LE DROIT DES AMENDEMENTS IDENTIQUES DE MONSIEUR MARIER	_
JE NE TE DEMANDE PAS CELA	JE NE LE PEUX DEMANDE METTRE PASSER LÀ	_
ET C EST DE CETTE FAÇON QU UNE ÉCONOMIE REDÉMARRE	ET C EST DE CETTE FAÇON QU ELLES SOIENT QU ILS N ÉTAIENT QUE LE MISÉRABLES	_
TIENS PERSONNE DANS SON ÉTUDE	QUI TIENS PERSONNE NE S EN EST TUÉE	_
HORTENSE IL DOIT MANGER COMME QUATRE	POURTANT IL DEMANDERANGEAIT COMME TÊTE	_
JE M EN FICHE DES VOISINS	JE M EN FIES DE REJOINDRE	_
PAR ESSENCE LA LOI EST ÉVOLUTIVE	APPLAUDISSEMENTS SUR LES BANCS DU GROUPE UMP	_
VINGT RÉSIDENCE DES TAMARIS	VINGT RÉSIDENCE DES HAUTS DU TAMPON	_
VOUS ÊTES MON SAUVEUR ET MON PÈRE	VOUS ÊTES MANGÉ MON SAVOIR ET MON PÈRE	_
AVENUE MONSEIGNEUR JEAN BATIOT À CHANTONNAY	AVENUE MONSEIGNEUR GRIMPA BATTU À CHÂTEAUNEUF	_
RUE DU SICANTIN SAINT DENIS EN VAL	RUE DU SEC ANANT À SAINT DENIS EN VAL	_
ON ÉTUDIERA QUATRE VINGT DOUZE LEÇONS CETTE ANNÉE	ON METTIT DIEU À QUATRE VINGT DOUZE MILLIONS D EUROS SUR CET ANNÉE	_
LES DEUX MEILLEURES ÉQUIPES	L AIDE DEUX MILLIARDS D EUROS	_
TRENTE EN COULEUR 0 FR	TRENTE EMPLOYEURS DES ROSES FIERURS FURENT	_
C EST QUELQUE CHOSE D INOUÏ	C ÉTAIT QUELQUE CHOSE D ICI	_
RUE DE PEYRE CRABÈRE LOURDES	RUE DE PERTRE TRAVAILBERT LONGUES LOURDES	_
CETTE COMPARAISON L EXCUSA	C ÉTAIT COMPLÈTEMENT À RAISON L EXPÉRIMENTATION	_
AU BORD DE LA RIVIÈRE C EST BIEN L ÉTÉ POUR ARROSER	BABOCHET DE LA RÉSIDENCE EST BIEN LA RÉPUBLIQUE POUR LA REJET	_
CELA N A PAS SUFFI	CELA N A PAS SUFFISAMIS	_
CETTE ATTENTE AVAIT ÉTÉ DÉÇUE	T AS VU LONGTEMPS AVEC LES ÉTABLISSEMENTS	_
C EST UN VRAI SUJET	C EST UN VRAI SUJET	_
LE TRAIN A DU RETARD AUJOURD HUI	LE TRAIN DU RAPPORT DU RETARD AUJOURD HUI	_
LA PAROLE EST À MONSIEUR FABIEN DI FILIPPO	LA PAROLE EST À MONSIEUR FRÉDÉRIC POISSON POUR SOUTENIR L AMENDEMENT	_
MERCI DE TA RÉPONSE	MERCI DE TA RÉPONSE	_
L UNIVERSITÉ EST FERMÉE TOUT LE MOIS D AOÛT	LES LARMES S ÉTAIENT FERMÉS TOUS LES MOIS	_
J AI ACHETÉ UN NOUVEAU CANAPÉ	J ACHÈTERAI UNE AUTRE DU PAPIER	_
J AIMERAIS SAVOIR QUAND DONC TU POURRAS VENIR AVEC NOUS	JE M EMMÈNERAI À SA VOITURE COMME NON TU POURRA VENIR AVEC NOUS	_
MON AMI SI JE PUIS	MON AMI SI JE PEUX PLUS	_
J AI CRU QU IL N EN FINIRAIT PAS AVEC SES SALAMALECS	J AI CRU QU IL AU FIGURE ABSOLUMENT PAS AVEC CES AMENDEMENTS IDENTIQUES	_
CINQ RUE LUDOVIC MASSÉ	S INSTRUIRE DE LA RÉPUBLIQUE MA SŒUR	_
MÈRE UBU QUE FAIS TU MALHEUREUX	MÈRE UBU QUE C EST DU MALHEUREUX	_
RÉGULUS RESTA SEUL	RUE DU LIEUTENANT SE RES CASSANS	_
MADAME GAUDIN SE LEVANT À PART	MADAME GROSBIN SE LEVANT À PART	_
CE N EST PAS L AVIS DE BONNARD	CE N EST PAS LA LIBRAIRIE DE VOULOIR	_
IL S AGIT EFFECTIVEMENT DE MON AMENDEMENT DE REPLI	IL S AGIT EFFECTIVEMENT D UN AMENDEMENT DE MON AMENDEMENT DE REPLI	_
DANS LE TENNIS LA PARTIE CONTINUE	DANS LE TÉLÉPHONE LORSQUE LA PARTIE CANTIE	_
MAINTENANT ELLE PÊCHE	MAINTENANT ELLES PÊCHENT	_
EN EFFET ÉDOUARD LE SOUTINT	EN EFFET ÉGALEMENT LE SOUPLE	_
LES JOUES MÛRES DE LA FAYETTE SE MARBRAIENT UN PEU	IL UTILISAIT DE LA FAILLETTE C EST MARRANT À PEINE	_
ROUTE NATIONALE DEUX CENTS À ALÉRIA	ROUTE DES LACS MAIGRESSON À ALÉRIEN	_
DE GUERCHARD L INSPECTEUR DE LA SÛRETÉ	DEUX GARŒS CHARLES L INSPECTEUR DE LA SUR ELLE	_
COMBIEN DE TEMPS VEUX TU VOYAGER	COMMENT ÊTES VOUS DANS VOTRE RÉPUBLICAIN	_
QUATORZE RUE DE KERCAVES	QUATORZE RUE DE CATHARÈS	_
TOUT LE MONDE ESPÈRE GAGNER CETTE COURSE	TOUT LE MONDE LES SPECTACLES DE CE CORRESPONDANCE	_
PLACE SUR LA CHAPELLE À LECT	PLACE SUR LA CHAPELLE LACATE	_
IL N A PAS RESPECTÉ LES RÈGLES	ILS N ONT PAS ASSEZ DE FAITES EXEMPLES	_
TU NE MANGES PAS ASSEZ	TU NE M ENNUIES PAS ASSEZ	_
LA NAISSANCE C EST LE MOMENT DE L HYPER RESPONSABILITÉ	L AMBASSADEUR C EST LE ROI DEMANDÉ RÈGLE RESPONSABILITÉ	_
J AI EU FULUP AU TÉLÉPHONE	J AI EU SUPPLÉMENT PROTÉGÉ LES FEMMES	_
CELLES QUI SONT MÉCONTENTES	CELLE QU ILS SOIENT SUR LE CONTENTT	_
ET TU L AS VU COMBIEN DE FOIS	ET TU L AVEZ VOUS CONNUE DE FOIS	_
NEUF RUE DU GITE	NEUF RUE DU JUTHET	_
CET AMENDEMENT ÉTAIT INÉVITABLE	CET AMENDEMENT ÉTAIT ÉGALEMENT ÉVIDEMMENT	_
SUR CET ARTICLE PLUSIEURS ORATEURS SONT INSCRITS	SURTOUT APPLAUDISSEMENTS SUR LES BANCS DU GROUPE SRC	_
ON AVAIT FAIT UN GROUPE DE TRAVAIL PENDANT HUIT MOIS	ON N AVAIT FAIRE AU BOUT DE TRAVAILLER DANS L URGENCE	_
ETALER LA PÂTE	ET TELLES L EÛT LA PORTE	_
IL VA POSER SON VERRE SUR LA TABLE	VOUS ÊTES FATIGUÉS SE LÈVRE SUR LA TABLE	_
VOUS AVEZ VOULU NOUS FAIRE LA LEÇON SUR TOUT	VOUS AVEZ ÉVOLUÉ NOUS FAIRE DANS LA FORTUNE SURTOUT	_
LES CHEVAUX DES OFFICIERS	LES CHEVAUX REPRENNENT LES OFFICIERS	_
NOUS PARLONS D UN CHANGEMENT DE MENTALITÉS	JE PARLONS D ABORD DE LA CHAREMENT DE MON CALCUL	_
L ORAGE EST À SON MAXIMUM	MAURAAGE ET TA SŒUR MARCHÉ LONGTEMPS	_
HÉLAS TELLE N EST PAS VOTRE STRATÉGIE	ET L ASSASSIN ELLE N EST PAS VOTRE STRATÉGIE	_
J APPRENDS L ANGLAIS DEPUIS UN MOIS	J APPRRAS L ENGLAIENT DE PLUS À MOI	_
C EST UN DÉBAT D ANTICIPATION DE PROSPECTIVE QU IL FAUDRAIT MENER	C EST DES BONNES IDÉES S PASSATION DE PROCEPTIONNELS DE PROFESSIONNELS	_
VOUS AVEZ DEUX SECONDES MONSIEUR LE DÉPUTÉ	VOUS AVEZ DÉCIDÉ MONSIEURMENT MONSIEUR LE DÉPUTÉ	_
SALLE DE LA MPT OU VÉRANDA	CELLE DE LA RÉPUBLIQUE DOMINICAIN	_
DELPHINE L ONDE AMÈRE	T ES FILS LONGUEMENT	_
MAIS PUISQUE VOUS L ORDONNEZ JE SUIS PRÊT À SORTIR	MAIS PUIS CE QUE VOUS LEUR DONNER JE SUIS PRÊT À S ARRÊTER	_
LÀ RÉSIDE TOUTE LA DIFFICULTÉ EN GÉOTHERMIE AUJOURD HUI	LA RÉSIDENCE TOUTE LA DIFFICILE À DES DIFFICULTÉS TERRITORIALES	_
DÉFENDU PAR LES HOMMES ORDONNÉ PAR DIEU	DÉFENDU DU PAR LES SONNELES POUR DEUX ÉPARGNEMENTS PARDEUX	_
LES PÈLERINAGES DOIVENT S ACCOMPLIR À PIED	L ÉPÉE DE LA RÉPUBLIQUE DOMINICAIN S ACCOMPLIÈRENT À PIED À PIED	_
DES GENS D UN PAYS LOINTAIN	DES GENS DONNENT LEUR PAYS LOINTAINS	_
IL SIFFLOTE EN REMONTANT LA RUE	IL SIFFLE EN TEMPS REMONTANT L HONNÊTE HOMME	_
JE TE CONSEILLE D EN PARLER	JE DEVAIS CONSEIL DANS PARIS	_
RUE CAPITAINE PAUL BOSC À AJACCIO	RUE DU CAPITAINE PAUL BOOSTE À AJACCIO	_
ELLE ÉTAIT DEVENUE SOMBRE	ELLE ÉTAIT DEVENUE SON BRAS	_
CETTE FEMME N A JAMAIS ÉTÉ LA MAÎTRESSE DE JACQUES	CETTE TRANQU ON N A JAMAIS ÉTÉ QU IL A MAÎTRE LA MAÎTRESSE DE JACQUES BLANC	_
UN SALADIER LUI ÉCHAPPE DES MAINS ET SE CASSE	À SALADIER DU CHASSEUR DEMAIN ET SE CASSAIT	_
OH MAIS IL EST D UN PRIMITIF EXAGÉRÉ	OH MAIS IL EST DONC IMPORTANT CRIMÉE ACCEPTABLE	_
TU TRAVAILLES BIEN TOI	TU TRRAS L ANGLAIS À TOI	_
SES LUNETTES SONT NOIRES	CELLE DU MATCH SON NOIRE	_
RUE PORTE SAINT PIERRE AU NUMÉRO CINQ	RUE MARCEL HACQUIÈRE AU NUMÉRO CINQ	_
ASSEZ MONSIEUR DE BELVERANA	ACCEPTEZ MONSIEUR MONSIEUR DE BELVERANA	_
AUTREFOIS ILS PÊCHÈRENT	AUTREFOIS UNE PÊCHÈRENT	_
IL N A PAS LA NÔTRE	ILS N ONT PAS LA LOGIQUE	_
EH BIEN LA MAISON ATTENDRA	EH BIEN LA MAISON EST LA TABLE	_
