QUE D EAU	QUE D EAU	_
JE NE ROUGIS PAS	JE NE ROUGE PAS	_
IL BOIT DE L EAU	IL BOIT DE L EAU	_
C EST SALE	C EST SALE	_
NE L ÉTANT PAS	NE L ÉTANT PAS	_
NOS TROIS FEUILLES	NOS TROIS FEUILLES	_
IL A RAISON	IL HARISSANT <eps>	_
LE TEMPS SERA CHAUD	LE TRANSFERT À CHAUD	_
LA MAISON EST GRANDE	LA MAISON EST GRANDE	_
NEUF HEURES ET QUART	NEUF HEURES ÉCARTS <eps>	_
TOUT EN FINESSE	CHARLES FÉNIS <eps>	_
NE PLEURE PAS	NE PLEURE PAS	_
C EST BON DE MANGER DU LAIT	C EST BON DE MANGER DU LAIT	_
DANS TA CHAMBRE	DANS TA CHAMBRE	_
C EST JOLI	C EST JOLI	_
HI HI HI HI	IL FIT QU ICI	_
QUI T ACCOMPAGNE	QUI T ACCOMPAGNE	_
C EST VOTRE OPINION	C EST VOTRE OPINION	_
IL N Y A PAS BEAUCOUP DE MONDE	IL N Y A PAS BEAUCOUP DE MONDE	_
COMMENT VA VOTRE SŒUR	COMMENT VA VOTRE SŒUR	_
IL FAUT QUE J Y ARRIVE	IL FAUT QUE J <eps> ARRIVE	_
CE SERAIT TROP LENT	CE SERAIT TROP LENT	_
POURQUOI N Y ALLEZ VOUS PAS	POURQUOI N Y ALLEZ VOUS PAS	_
VAS T EN	VA T EN	_
VINGT ET UN LIVRES NOIRS	VINGT ET UN LIVRES NOIRS	_
C EST COMME ÇA	C EST COMME ÇA	_
NE M ATTAQUEZ PAS	NE METTAQUEZ PART <eps>	_
VOUS ÊTES PRÊT	VEUT <eps> PRÊT	_
C EST LA RÉALITÉ	C EST LA RÉALITÉ	_
ELLE EST BIEN	ELLE EST BIEN	_
ELLES VONT TRÈS BIEN	ELLE VEND TRÈS BIEN	_
OÙ SUIS JE	OÙ SUIS JE	_
LE PLUS QU IL PEUT	LE PLUS QU IL PEUT	_
ÇA M EST ÉGAL	ÇA M EST ÉGAL	_
C EST COMBIEN ÇA	C EST COMBIEN ÇA	_
L OISEAU QUI NE CHANTE PLUS	L OISEAU QUI NE CHANTE PLUS	_
UNE TRENTAINE DE KILOS DE BANANES	UNE TRENTAINE DE PHILOS DE BANANE	_
SURTOUT PARMI VOS AMIS	SURTOUT PARMI AUX AMIS	_
QUEL ÂGE ONT ILS	QU IL A GENTIL	_
MA FILLE N EST PAS ICI	MA FILLE N EST PAS ICI	_
C EST UNE ÉVIDENCE	C EST UNE ÉVIDENCE	_
LA DIX HUITIÈME	LA DIX HUITIÈME	_
À QUELLE HEURE VOUS ÊTES VOUS LEVÉ	À QU HEURE VOUS ÊTES VOUS LEVÉ	_
J ACCEPTAI TOUT DE SUITE	J ACCEPTAIT TOUT DE SUITE	_
COMMENT VA TOUT LE MONDE	COMMENT VA TOUT LE MONDE	_
ELLE VA ME TAPER	ELLE VA ME TAPER	_
LE MORCEAU DE PAIN	LE MORCEAU DE PAIN	_
IL EST CHAUD	IL EST CHAUD	_
IL ARRIVE BIENTÔT	IL ARRIVE BIENTÔT	_
ELLE ELLE AIMAIT	ELLE ELLE AIMAIT	_
IMPOSSIBLE DE ME RAPPELER	IMPOSSIBLE DE ME RAPPELER	_
C EST TROP GRAND	C EST TROP GRAND	_
ON M A DIT D ALLER À L ÉCOLE	ON M A DIT D ALLER À L ÉCOLE	_
C EST MA SŒUR AÎNÉE	CES <eps> MA SŒURS AÎNÉES	_
IL N EST PAS MAUVAIS	IL N EST PAS MAUVAIS	_
MAIS IL EST PARTI	MAIS IL EST PARTI	_
C EST SIGNÉ DIDIER MIGAUD <eps>	<eps> EST SIGNÉ D ITIE MIGO	_
À LA BONNE HEURE	À LA BONNE HEURE	_
D OÙ VIENT L ARGENT	D OÙVIENT <eps> L ARGENT	_
LE BEAU TEMPS	LE BEAU TEMPS	_
IL EST TEMPS	IL EST TEMPS	_
VOUS VENEZ CE SOIR	VOUS VENEZ CE SOIR	_
LE PARTI ÉTAIT BIEN MALADE	LE PARTI ÉTAIT BIEN MALADE	_
C EST TON TOUR	C EST TON TOUR	_
ELLES ELLES ONT ÉTÉ AIMÉES	ELLES ELLES ONT ÉTÉ AIMÉES	_
IL N Y A PAS DE CHAISES	IL N Y A PAS DE CHAISE	_
IL Y EN A	IL Y EN A	_
L AFFAIRE FIT GRAND BRUIT	L AFFAIRE FAIT GRAND BRUIT	_
AUCUNE AUTRE CHAISE	AUCUNE AUTRE CHAISE	_
VOUS ÊTES FATIGUÉES	VOUS ÊTES FATIGUÉ	_
ON A AIMÉ	ON A AIMÉ	_
LAISSE MOI TRANQUILLE	LAISSEMENT <eps> TRANQUILLE	_
ON DÉPLACE L ÉQUILIBRE	ON DÉPLACE L ÉQUILIBRE	_
C EST UNE MAISON	C EST UNE MAISON	_
TU ES ICI	TU ES ICI	_
GARÇON OU FILLE	GARÇONS AUX FILLES	_
DES JOUEURS VIOLENTS	DES JOUEURS VIOLENTS	_
QUI Y A T IL	QU Y A T IL	_
JEAN NOUS SOMMES VOISINS	JEAN NOUS SONGS VOISINS	_
POUR EUX CE SERAIT UNE AIDE	POUR EUX CE SERAIT UNE ÊTRE	_
L ORAGE A REDOUBLÉ	L ORAGE ARRIVE DEMEURE	_
ELLE CHANGEA DE COULEUR	ELLE CHANGEA DE COULEUR	_
MADAME EST ALLÉE À PARIS	MADAME EST ALLÉ À PARIS	_
C EST EXACT	PEUT <eps> EXACT	_
IL EST TEMPS D Y ALLER	IL EST ENDIAL <eps> <eps> <eps>	_
IL EST DE SUPPRESSION	IL EST DE SUPPRESSION	_
MOI J AI AIMÉ	MOI JAMAIS <eps> <eps>	_
RUE DE SABEL BARJAC	RUE DE SABELLE BARJAC	_
MAIS PARFOIS SUR LA COMPARAISON	MAIS PARFOIS SUR LA COMPARAISON	_
C EST PAS JUSTE	C EST PAS JUSTE	_
ÇA SE POURRAIT	ÇA CE POURRAIT	_
ON L AIMAIT MALGRÉ TOUT	ON LES MÊME MALGRÉ TOUT	_
FEU DANS LA CHEMINÉE	FEUX DANS LA CHEMINÉE	_
VOILÀ QUI EST VRAI	VOILÀ QUI EST VRAI	_
IL NE FAIT QUE MANGER	IL NE FAIT QUE MANGER	_
JE M APPELLE RAJA	JE M APPELLE RAJAT	_
C EST TROP TARD	C EST TROP TARD	_
ON VA BIEN HAUT AINSI	ON VA BIEN OU AINSI	_
IL DEVRA ÊTRE QUELQUE PART	IL DEVRA ÊTRE QUELQUE PART	_
IL NE FAIT PAS BEAU AUJOURD HUI	IL NE FAIT PAS BEAU AUJOURD HUI	_
ELLES SONT EN TRAIN DE COURRIR	ELLES SONT EN TRAIN DE COURIR	_
ON PEUT MÊME LE TROUVER EN PELUCHE	ON PEUT MÊME LE TROUVER EN PELUCHE	_
ATTENDEZ UN PETIT MOMENT TÉLÉPHONE	RÉPONDEZ ACTIVEMENTER CÉLÉBRE <eps> <eps>	_
SES PARENTS SONT SÉPARÉS	SES PARENTS SONT SÉPARÉS	_
POUR QUE NOUS PÊCHIONS	POUR QUE NOUS PÊCHIONS	_
DES POMMES DE TERRE EN ROBE DES CHAMPS	DE POMMES DE TERRE EN ROBE DES CHAMPS	_
C EST LÀ QU	C EST LA CLÉ	_
TU ES SÛR QUE NOUS AIMERONS	TU ES SÛR QUE NOUS AIMERONS	_
MAINTENANT IL PÊCHE	MAINTENANT ELLE PÊCHENT	_
IL Y A DES MALADES PARMI ELLES	IL Y A DES MALADES PARMI ELLES	_
TROIS VILLAGE DE LAFONTASSE <eps>	TROIS VILLAGES DE LA FONTASSE	_
POUR QU IL PÊCHE	POUR QU ILS PÊCHENT	_
<eps> UN PAUVRE IMBÉCILE	COMPRENDRE UN DOSSIER <eps>	_
DITES MOI S IL VOUS PLAIT	DITES MOI S IL VOUS PLAIT	_
C EST TOI QUI L A	C EST AU QUI L A	_
INVITÉS DES DEUX SEXES	INVITÉS DES DEUX SEXES	_
QU AVEZ VOUS DONC	QU AVEZ VOUS DONC	_
MÈRE DE LAMINE	MAIRE DE LAMINE	_
ELLE SERA AVEC NOUS DEMAIN	ELLE SERA AVEC NOUS DEMAIN	_
ET J ACHÈVERAI MON DEVOIR	IL ESTCHÉRAIT <eps> MON DEVOIR	_
C EST UNE BELLE COUPE DE FILLE	C EST UNE BELLE COUPE DE FILLE	_
FAITES COMME JE VOUS DIS	FAITES COMME JE VOUS DIS	_
IL Y A DES RICHES À ETEL	IL Y A DES RICHES À TELS	_
IL EN A BESOIN	IL EN A BESOIN	_
TU NE MANGES <eps> PAS ASSEZ	CE NE M ENGE PAS ASSEZ	_
AVEC QUOI VOUS DIVERTISSEZ VOUS	AVEC QUOI VOUS DIVERTISSEZ VOUS	_
SON FOND EST PLAT	SON FOND EST PLAT	_
LA MAISON EST JOLIE	LA MAISON EST JOLIE	_
OÙ EST ELLE	OÙ EST ELLE	_
IL EST CAPABLE OUI OU NON	IL EST CAPABLE OUI OU NON	_
NON JE SUIS LÀ	NON JE SUIS LÀ	_
LA FAILLITE MENAÇAIT	LA FAILLITE MENACÉE	_
NE VIENS PAS ICI	NE VIENT PAS ICI	_
NE CRAIGNEZ RIEN POUR MA SANTÉ	NE CRAIGNEZ RIEN POUR MA SANTÉ	_
IL TRÉPIGNE D IMPATIENCE	IL TRÉPIGNE D IMPATIENCE	_
J AI ÉTÉ DIPLÔMÉ MAIS	J ÉTAIS <eps> DIPLÔMÉ MAIS	_
QU IL EST BÊTE	KHILL <eps> <eps> BÊTE	_
CE FUT UN GROS TRAVAIL	CE FUT UN GROS TRAVAIL	_
JE L AIME ENCORE	JE L AIME ENCORE	_
NE BOUGEZ PAS	NE BOUGEEZ PAS	_
VOUS NE LE SAVIEZ PAS	VOUS NE LE SAVIEZ PAS	_
UN AUTRE EST FUSILLÉ	UN AUTRE EST FUSILLÉ	_
IL VA LE TUER ROXANE	IL VA LE TUER ROXANE	_
ON NE PEUT PAS DIRE ÇA	ON NE PEUT PAS DIRE ÇA	_
PUIS IL APPELA GAVROCHE	PHILIPPE IL APPELA GAVROCHE	_
QU EST CE QUE C EST MOI	QU EST CE QUE C EST MOI	_
VINGT QUATRE HEURES	VINGT QUATRE HEURES	_
IL N EST PAS AVEC VOUS	IL N EST PAS AVEC VOUS	_
ÇA C EST ÊTRE CONNU	ÇA C EST ÊTRE CONNU	_
C EST DÉJÀ FAIT	C EST DÉJÀ FAIT	_
ELLE NE RÉPONDIT PAS	ELLE NE RÉPONDIT PAS	_
C EST DU CAPORALISME	C EST LE CRAPOVALISME	_
L HEURE DU DÎNER	L HEURE DU DÎNER	_
ASSUMEZ VOS CHOIX	ASSUNEZ VOS CHOIX	_
QU AVEZ VOUS OUVERT	QU AVEZ VOUS OUVERT	_
ON N A PAS ÉTÉ DÉÇUS	ON N A PAS ÉTÉ DÉÇU	_
RÉPARTISSONS LES CHOSES	REPARTISSONS LES CHOSES	_
ET LA LAISSER PRENDRE LA SUITE	IL A LAISSÉ PRENDRE LA SUITE	_
JE SUIS À LA FENÊTRE	JE SUIS À LA FENÊTRE	_
LE MINISTÈRE DE LA SANTÉ RESTE VACANT	LE MINISTÈRE DE LA SANTÉ RESTE VACANT	_
SA CARRIÈRE DÉBUTE	SA CARRIÈRE DÉBUTE	_
TU ES SÛR QU IL AIME	TU ES SÛR QU IL AIMAIT	_
C ÉTAIT LOUIS <eps>	C EST ELLE OUI	_
SI JE LE SAIS	SI JE LE SAIS	_
NON C EST LA PREMIÈRE FOIS	NON C EST LA PREMIÈRE FOIS	_
IL A FAIT PARTIE DE LA FRANC MAÇONNERIE	IL <eps> FAIT PARTIE DE LA FRANC MAÇONNERIE	_
C EST TRÈS DISCUTABLE	C EST TRÈS DISCUTABLE	_
J AIME L ANGLAIS	J AIME L ANGLAIS	_
TU ES PARENT AVEC M MOHAN	SUÉ <eps> PARENT AVEC MONSIEUR MOINE	_
ELLE AIMERAIT TA SŒUR	ELLE AIMERAIT TA SŒUR	_
DONNONS LUI DE L OCCUPATION	DONNANT LUI DE L OCCUPATION	_
QUE LE TEMPS EST BEAU DANS TON PAYS	QUE DE TEMPS EST BEAU DANS MON PAYS	_
IL JOUA D ABORD AU THÉÂTRE ITALIEN	IL JOUA D ABORD AU THÉÂTRE ITALIEN	_
JE VAIS À TABLE	JE VAIS ATTABLE <eps>	_
A LA BONNE HEURE	À LA BONNE HEURE	_
SEPT RUE DE LA MARTINELLE	SEPT RUE DE LA MARTINEN	_
MARY ET ST	MARIE ET ST	_
CERTES SI VOUS RESTEZ LÀ	CERTES SI VOUS RESTEZ LÀ	_
VOUS CONNAISSEZ PARFAITEMENT LES LIEUX	VOUS CONNAISSEZ PARFAITEMENT LES LIEUX	_
ON NE SAIT FIT BRIENNE	ON NE SAIT FIBRIENNE <eps>	_
ELLE POURSUIT UNE CARRIÈRE MUSICALE	ELLE POURSUIT UNE CARRIÈRE MUSICALE	_
J Y AI RÉUSSI JUSQU À PRÉSENT	J Y AI RÉUSSI JUSQU À PRÉSENT	_
LE PLUS ANCIEN	LE PLUS ANCIEN	_
MAIS REGARDE MOI DONC	MAIS REGARD MOI DONC	_
JE LES IGNORAIS	JE LES IGNORAIS	_
IL LUI PARDONNE	IL LUI PARDONNE	_
C EST LÀ BAS	C EST LÀ BAS	_
VOUS ÊTES SI BONNE POUR MOI	VOUS ÊTES SI BONNE POUR MOI	_
QUI LISAIT ENCORE DES LIVRES	QUI LISAIT ENCORE DES LIVRES	_
CET ENDROIT ME PLAIT	CET ENDROIT ME PLAÎT	_
ELLE ÉTAIT TROP ÉPOUVANTÉE	ELLE ÉTAIT TROMPE ÉPOUVANTÉE	_
SIX RUE BRÈVE	CYRUBRÈVE <eps> <eps>	_
QU ENTEND ON	QUANT EN TANT	_
C EST LES VACANCES	C EST LES VACANCES	_
DIT ELLE ENTRE SES DENTS	DIT ELLE ENTRE SES DENTS	_
ELLE EST CHAUDE	ELLE EST CHAUDE	_
BONNE ANNÉE À VOUS	BONNE ANNÉE À VOUS	_
CAR JE LE CROIS TRÈS MALHEUREUX	CAR JE LE CROIT TRÈS MALHEUREUX	_
EST CE QU IL VIENDRA	EST CE QU IL VIENDRA	_
CLÉMENCE EST RASÉE	CLÉMENCE EST RASÉ	_
RUE JEAN GIRARD BOURGES	RUE JEAN GIRARD BOURGES	_
IL EST PARTI	IL EST PARTI	_
IL DOIT COMPRENDRE	IL DOIT COMPRENDRE	_
TOUS LES PLANCHERS SONT EN BOIS DUR	TOUT LE PLANCHER SONT EN BOIS DIRE	_
LE RIDEAU S OUVRE	LE RIZ DE SOURD	_
CE N EST PLUS DE NOTRE ÉPOQUE	CE N EST PLUS <eps> NOTRE ÉPOQUE	_
SI PEU QUE RIEN	SI PACRURIUM <eps> <eps>	_
SON CORPS N EST PAS LÀ	SON CORPS N EST PAS LÀ	_
J AI DEUX FRÈRES ET UNE SŒUR	J AI DEUX FRÈRES ET UNE SŒUR	_
IL EST ICI	IL EST ICI	_
UN PANTALON BEAUCOUP TROP SERRÉ	UN PANTALON BEAUCOUP TROP SERRÉ	_
D OÙ VIENS TU	DE <eps> VIENS TU	_
LE JEU EST DÉSORMAIS FERMÉ	LE JEU EST DÉSORMAIS FERMÉ	_
QUAND CELA SERA T IL PRÊT	QUAND CELA SERA T IL PRÈS	_
LA CHAISE EST CASSÉ	LA CHAISE EST CASSÉE	_
LE TEMPS PASSÉ	LES THÈMES PASSAIENT	_
PASSANT ENTENDS TU BÉGAYER À LA FOIS	PASSANT TANT TU BÉGAYER À LA FOIS	_
ON EST À L ORDRE	ON NAÎT À L ORDRE	_
VOUS VOUS AIMEZ	VOUS VOUS AIMEZ	_
C EST POURQUOI	C EST POURQUOI	_
JE L AI VU	JE L AI VU	_
LE SORT LE PREMIER NUMÉRO	LE SORT LE PREMIER NUMÉRO	_
C EST LUI QUE J AIME LE PLUS	C EST LUI QUE J AIME LE PLUS	_
L AFFAIRE SERA CHAUDE	L AFFAIRE SERA CHAUDE	_
C EST COMPLÈTEMENT DÉBILE <eps>	C EST COMPLÈTEMENT DES VILLES	_
LE VIEUX N EN DORMAIT PLUS	LE VIEUX N ONT DORMI PLUS	_
HIER ELLE PÊCHAIT <eps>	HIER C EST DÉPÊCHÉ	_
AU PROFIT DES GRECS	AU PROFIT DES GRECS	_
JE N EN SAIS RIEN	JE N EN SAIS RIEN	_
D AUTRES ANIMAUX JAUNES	D AUTRES ANIMAUX JAUNES	_
JE SUIS EXTRÈMEMENT SATISTFAIT	JE SUIS EXTRÊMEMENT SATISFAIT	_
UN DÉCRET POURRAIT EN PRÉCISER LA DÉFINITION	UN DÉCRET POURRAIT EN PRÉCISER LA DÉFINITION	_
NE LUI OUVREZ PAS LA BOUCHE DE TOUT CELA	NE LUI OVRAIT PAS LA BOUCHE DE TOUT CELA	_
IL EST LÀ	IL EST LÀ	_
ET ELLE VIENDRA	ET ELLE VIENDRA	_
LEQUEL EST VOTRE SAC	LEQUEL EST VOTRE SEC	_
JUSQU À MINUIT <eps> LA MAISON FUT EN L AIR	JUSQU À DE NUIT LA MAISON FUT EN L AIR	_
QU EST CE QUE TU PENSES	QU EST CE QUE TU PENSES	_
À DEMAIN VOTRE HONNEUR	À DEMAIN VOTRE HONNEUR	_
LE COMBIEN SOMMES NOUS	LE COMBIEN SOMMES NOUS	_
EMPRUNTEZ LA AVEC COURAGE	EMPRUNTEZ LÀ AVEC COURAGE	_
LA SYNAGOGUE EST AU DEUXIÈME ÉTAGE	LA SYNAGOGUE EST AU DEUXIÈME ÉTAGE	_
VOUS EN AUREZ D AUTRES	VOUS EN AUREZ D AUTRES	_
IL EST FILS DE MÉDECIN	IL EST FILS DE MÉDECIN	_
C EST SALE	C EST SALE	_
CHEMIN DU GOURD MONTAGNAT	CHEMIN DU BOURG MONTAGNAT	_
TRÈS BIEN J AIME MIEUX ÇA	TRÈS BIEN J AIME MIEUX ÇA	_
OH MERCI BEAUCOUP	OH MERCI BEAUCOUP	_
L OUVRAGE A TROIS TRAVÉES	L OUVRAGE A TROIS TRAVÉES	_
CET ARTICLE DEUX EST UNE RÉGRESSION	CET ARTICLE DEUX EST UNE RÉGRESSION	_
PERSONNE N A OUBLIÉ LA CHIMÈRE	PERSONNE N A OUBLIÉ LA CHIMÈRE	_
MISE EN SCÈNE DE MOCKER	MISE EN SCÈNE DE MOKER	_
SON FONCTIONNEMENT EST LE SUIVANT	SON FONCTIONNEMENT EST LE SUIVANT	_
JE LUI ÉCRIVIS UNE LETTRE	JE LUI ÉCRIVIS UNE LETTRE	_
JE VEUX VOUS DONNER UN CADEAU	JE VAIS VOUS DONNER UN CADEAU	_
IL EST DISSOUS DE FAIT	IL EST DISSOUS DE FAIT	_
RÉCEMMENT J AI VU UN HOMME	RÉCEMMENT J AI VU UN HOMME	_
JE SOUTIENS L AMENDEMENT DE MONSIEUR LAURENT	JE SOUTIENS L AMENDEMENT DE MONSIEUR LAURENT	_
MÂTIN ÇA SENT BON <eps>	MATIN ÇA S EN NOM	_
JE SUIS SÛR QUE J AIME	JE SUIS SÛR QU ILS AIME	_
LES DEUX LIMITES NE PEUVENT ÊTRE ATTEINTES	LES DEUX LIMITES NE PEUVENT ÊTRE ATTEINTES	_
T ES VRAIMENT UN GROS CON ENGUERRAND	DES <eps> VRAIMENT <eps> GROS CONVIRONS <eps>	_
JE SUIS TRÈS STRICT	JE SUIS TRÈS STRICT	_
ALLER À MADAGASCAR	ALLER À MADAGASCAR	_
BELLE ROSE LE CONDUISIT À SUZANNE	BELLE ROSE LE CONDUISIT À SUZANNE	_
ELLE MARCHE DANS L HERBE RASE	ELLE MARCHE DANS L HERBE RAZE	_
IL PARAISSAIT M ÉVITER <eps>	IL PARAÎT ASSEZ MAIS EUSTÉ	_
SON CHEF LIEU EST LA VILLE DE GARZA	SON CHEF LIEU EST LA VILLE DE GARZA	_
VOUS AVEZ D EXCELLENTES LECTURES	VOUS AVEZ D EXCELLENTE LECTURE	_
IL Y A UNE AUTRE RAISON	IL Y A UNE AUTRE RAISON	_
TU AS RAISON DE RESTER GARÇON	TU AS RAISON DE RESTER GARÇONS	_
EH BIEN LE N HUIT	EH BIEN LE NUMÉRO HUIT	_
CERTES IL VOUS AIME	CERTES IL VOUS AIME	_
DELPHINE SONT DES HOMMES DE SIX COUDÉES	DELPHINE SONT LES HOMMES DE SIX COUDÉS	_
IL M AVAIT DIT CELA EN RIANT	IL M AVAIT DIT CELA EN RIANT	_
C EST RIDICULE	CES RIDICULES <eps>	_
C EST CELUI CI LE TIEN	C EST CELUI CI LE TIENT	_
CE SONT LESQUELLES	CESSANT REQU ELLES	_
C EST POURTANT CE QUE VOUS FAITES EN PERMANENCE	C EST POURTANT CE QUE VOUS FAITES EN PERMANENCE	_
MAIS JE CITERAI UN SEUL EXEMPLE	MAIS JE CITERAI UN SEUL EXEMPLE	_
RIEN QUE CELA	RIEN QUE CELA	_
IL EST PERDU LE GARÇON	IL EST PERDU LE GARÇON	_
C EST UNE GROTTE PRIVÉE	C EST UNE BROADGE PRIVÉE	_
J AI ADORÉ CE FILM	J AI ADORÉ CE FILM	_
DEMAIN OU HIER	DEMAIN UNE GUERRE	_
IL Y A UNE ÉCOLE DE LANGUES	IL Y A UNE ÉCOLE DE LANGUES	_
ELLE LUI DIT TU SERAS PENDU	ELLE LUI DIT CERA PENSE <eps>	_
QUEL ÂGE AS TU	QUEL ÂGE AS TU	_
EH BIEN JE VERRAI QU IL N Y A RIEN À VOIR	HÉBERGÉ <eps> <eps> <eps> QU IL N Y <eps> RIEN D AVOIR	_
À ENCOURAGER LA CROISSANCE	À ENCOURAGER LA CROISSANCE	_
UNIVERSITÉ DE LAVAL	UNIVERSITÉ DE LAVAL	_
TOI AUSSI TU ES DE CEUX LÀ	TOI AUSSI TU ES DE CELA <eps>	_
D AUTRES GRANDES CHAISES	D AUTRES GRANDES CHAISES	_
RUE PELLETAN AU NUMÉRO SEPT	RUE PELLETAN AU NUMÉRO SEPT	_
ON TE VERRA DEMAIN	ON TE VERRA DEMAIN	_
IL FUT DOUBLE DISQUE D OR	IL FUT DOUBLE DISQUE D OR	_
IL DESSINE AUSSI DES MEUBLES	IL DESSINE AUSSI DES MEUBLES	_
ELLE REVIENT VERS ANTOINE	ELLE REVIENT VERS ANTOINE	_
C EST LA FAUTE DE QUI	C EST LA FAUTE DE QUI	_
ON L A FRAPPÉ	ON L A FRAPPÉ	_
C EST UNE EXPERTE	C EST UNE EXPERTE	_
EN BREF JE DÉMISSIONNE	EN BREF JE DÉMISSIONNE	_
EST CE QUE ÇA LUI COÛTE <eps> DE L ARGENT	EST CE QUE C EST L ÉCOUTE DE L ARGENT	_
ÉGLISE SAINT CLÉMENT	ÉGLISE SAINT CLÉMENT	_
OBJECTIVEMENT C EST UN TRAVAIL DE LONGUE HALEINE	<eps> C EST LE TRAVAIL DE LANGUEDALE <eps>	_
ELLE EST AUJOURD HUI TOTALEMENT IGNORÉE	ELLE EST AUJOURD HUI TOTALEMENT IGNORÉE	_
PAS MÊME LE CAPITAINE NEMO	PAS MÊME LE CAPITAINE NEMO	_
L ENFANT DONT LE BRAS EST CASSÉ	L ENFANT DANS LE BRUN EST CASSIS	_
ON LES TROUVE DANS LES PLANTES	ON LES TOMBE DANS LES PLANS	_
ELLE EST TROP BELLE	ELLE EST TROP BELLE	_
SANS COMPTER LA YOUGOSLAVIE ET L EGYPTE	SANS COMPTER LA YOUGOSLAVIE DE L ÉGYPTE	_
N Y A QU À NE PAS SE METTRE EN SERVICE	N Y A QU À <eps> <eps> SE METTRE EN SERVICE	_
C EST RESPECTUEUX DE L ENVIRONNEMENT	C EST RESPECTUEUX DE L ENVIRONNEMENT	_
JE SUIS SÛR QUE VOUS AIMÂTES	JE SUIS SÛR QUE VOUS AIMÂTES	_
MAIS POUR SOULIGNER TES RATAGES	MAIS POUR SOULIGNY THÉRATAGE <eps>	_
JE ME PERDS	JE M EMPEREUR	_
COMBIEN EST CE QUE ÇA COÛTERA	COMBIEN <eps> CE QUE ÇA COÛTERA	_
SEUL LE DOCTEUR BREUER LE SOUTIENT	SEULS D AUTRES BROEEURS LE SOUTIENT	_
JE SUGGÈRE LE RETRAIT DE CES AMENDEMENTS	JE SUGGÈRE LE RETRAIT DE CES AMENDEMENTS	_
LA MACHINE FONCTIONNE	LA MACHINE FONCTIONNE	_
QUI VOUS A TÉLÉPHONÉ	QUI VOUS A TÉLÉPHONÉ	_
ET PUIS IL ÉTAIT MINISTRE	ET PUIS IL ÉTAIT MINISTRE	_
VINGT TROIS TABLES	VINGT TROIS TABLES	_
DE JANE MOUTON ET AL	DE JEANNES MOUTONS ET ARLES	_
IL LA MET DANS SON GOUSSET	IL LA MET DANS SON GOUSSET	_
PLACE DE L ALLÉE À SEIX	CLASSE DE L ALLÉE À SEXE	_
LA FÉDÉRATION DE RUSSIE	LA FÉDÉRATION DE RUSSIE	_
PEUT ÊTRE LE SAIT ELLE	PEUT ÊTRE LE CENTRE <eps>	_
LA PRINCIPAUTÉ PREND LE NOM DE SARUHAN	LA PRINCIPAUTÉ PREND LE NOM DE SARUHEN	_
L HOMME D AFFAIRE RÉAGIT	L HOMME D AFFAIRES RÉAGIT	_
MAIS OÙ EST DONC LE PÈRE UBU	MAIS OÙ EST DONC LE PÈRE UBU	_
LES QUATRE GROS	LES QUATRE GROS	_
MAINTENANT TU PÊCHES	MAINTENANT TU PÊCHES	_
LE RETAIL AU NUMÉRO QUATRE	LE RETAIL AU NUMÉRO QUATRE	_
CERTAINS N ONT JAMAIS ÉTÉ RECONSTRUIT	CERTAINS N ONT JAMAIS ÉTÉ RECONSTRUITS	_
PERSONNE D AUTRE NE SAIT ÇA	PERSONNE D AUTRE NE CESSA <eps>	_
LE VILLAGE COMPTE UNE ÉGLISE	LE VILLAGE COMPTE UNE GLISME	_
VOUS AUREZ DE L EAU OU DU CAFÉ	VOUS AUREZ DELOS <eps> <eps> OU DU CAFÉ	_
DANS CETTE SOMBRE IMMENSITÉ	DANS CETTE SOMBRE IMMENSITÉ	_
AH NOUS SOMMES PROPRES	AH NOUS SOMMES PROPRES	_
LES VALVES SONT SUSPENDUES	LES VALVES SONT SUSPENDUES	_
NOUS AVONS ÉTÉ AIMÉS	NOUS AVONS ÉTÉ AIMÉS	_
C EST SON PREMIER ALBUM	C EST SON PREMIER ALBUM	_
À LA MAISON IL Y A TROIS TÉLÉVISEURS	À LA MAISON IL Y A TROIS TÉLÉMISEURS	_
SUR LE TREIZIÈME	SUR LE TREIZIÈME	_
LA ZÉLÉE EST COULÉE	LA ZÉLÉE EST COULÉE	_
NOUS N AVONS PAS À ROUGIR	NOUS N AVONS PAS À ROUGIR	_
QUAND DONC EN VERRAI JE LA FIN	QUAND DONC ENVIRÈGE <eps> <eps> LA FIN	_
SA SAVEUR EST ÂCRE	SA SAVEUR EST ÂCRE	_
ON COMPREND MIEUX POURQUOI CETTE LOI N EST PAS APPLIQUÉE	ON COMPREND MIEUX POURQUOI CELA <eps> N EST PAS APPLIQUÉ	_
DEUX MAISONS BLANCHES	DE MAISON BRANCHES	_
VOILÀ JUSTEMENT CE QUE NOUS VOULONS APPRENDRE	VOILÀ JUSTEMENT CE QUE NOUS VOULONS APPRENDRE	_
ON A L HABITUDE	ON A L HABITUDE	_
VENGEONS NOUS DU BOUFFON	VENGEONS NOUS DU BOUFFON	_
IL ÉTAIT MAL À L AISE	IL ÉTAIT MAL À L AISE	_
VOICI POUR LES DÉPENSES	VOICI POUR LES DÉPENSES	_
JE PRENDRAI LA MÊME CHOSE	JE PRENDRAI LA MÊME CHOSE	_
J AIMAIS MIEUX LES CHEVAUX	J AIMAIS BIEN LES CHEVAUX	_
NOUS MARCHERONS DANS L HERBE À PAS SILENCIEUX	NOUS MARCHERONS DANS L HERBE À PAS SILENCIEUX	_
EH BIEN EST IL RÉVEILLÉ	LES BIENS FÊTIRENT ÉVEILLÉS <eps>	_
L AFFRONTEMENT ÉTAIT INÉVITABLE	L AFFRONTEMENT ÉTAIT INÉVITABLE	_
RIEN D AUTRE	RIEN D AUTRE	_
L ADRESSE CINQ RUE DESROUSSEAUX	L ADRESSE CINQ RUE DESROUSSOUS	_
DONNEZ LUI DES VÊTEMENTS QUI NE GRATTENT PAS	DONNEZ LUI DES VÊTEMENTS QUI NE GRATTE PAS	_
YVONNE QUI VEUT ÉCOUTER	YVONNE QUI VEUT ÉCOUTER	_
IL TRAVAILLE MAL	IL TRAVAILLE MAL	_
ÇA AUGMENTE D HEURE EN HEURE	ÇA AUGMENTE D HEURES HONNEURS <eps>	_
DEMAIN ELLES PÊCHERONT	DEMAIN ELLE PÊCHERA	_
TA FILLE EST ELLE PRÉVENUE	SA FILLE EST ELLE PRÉVENUE	_
VOUS NE PRENEZ RIEN	VOUS NE PRENEZ RIEN	_
APERCEVANT EDGARD AU FOND	APERCEVANT EDGARD AU FOND	_
ES TU MALADE DEMANDÉ JE	ET TU MALADES DE MAUVAISGE	_
FAITES LE TOUR	PASSE LE TOURNOI	_
UN BILLET ALLER	UN BILLET ALLEZ	_
LE COMMISSAIRE TRÈS BIEN	LE COMMISSAIRE TRÈS BIEN	_
PERSONNE N Y COMPREND RIEN	PERSONNE N Y COMPREND RIEN	_
PEUT ÊTRE VIENDRA T ELLE QUI SAIT	HÔTEL <eps> VIENDRA T ELLE QUI SAIT	_
IL EST NÉ DANS LES HAUTES ALPES	IL EST NÉ DANS LES HAUTES ALPES	_
IL EST ENTERRÉ	IL EST ENTERRÉ	_
TU ES SÛR QU ON AIME	TU ES SÛR QU ON AIME	_
LA POURSUITE CONTINUE	LA POURSUITE CONTINUE	_
ON PEUT AUSSI Y FAIRE DU PARAPENTE	ON PEUT AUSSI <eps> FAIRE DU PARAPENTE	_
IL Y A DES MALADES <eps> PARMI EUX	IL Y A DES MALHEURS À PARMI EUX	_
QU ELLE GARDA EN TRAVERS DE LA GORGE	QU ELLE GARDA EN TRAVERS DE LA GORGE	_
IL POURSUIT ENSUITE SES ÉTUDES DE DROIT	IL POURSUIT ENSUITE SES ÉTUDES DE DROIT	_
DEUX TABLES NOIRES	DEUX TABLES NOIRES	_
JE VIENS DE LA METTRE À LA PORTE VOTRE JEANNETTE	JE VIENS DE LA METTRE À LA PORTE VOTRE GENNETTE	_
IL FAUT QUE JE TRAVAILLE PLUS	IL FAUT QUE JE TRAVAILLE PLUS	_
LA CONVERSATION S ÉGARA	LA CONVERSATION S ÉGARA	_
ELLE VIT À FELDAFING <eps> <eps>	ELLE VIT À CELLE D AFFIGNE	_
C EST MON CAS CE SOIR	C EST MON CAS CE SOIR	_
QU EST CE QUE VOUS FAITES DIMANCHE	QU EST CE QUE VOUS FAITES DIMANCHE	_
RUE D ELBINGERODE À BOULIGNY	RUE DELBENJERODE <eps> À BOULIGNY	_
IL OBJECTE IL RÉSISTE	IL OBJECTE IL RÉSISTE	_
LE DOIGT MARQUE LA DIRECTION	JE DOIS MARQUE LA DIRECTION	_
CELA N A PAS DE FIN SI L ON DOIT INVITER TOUT LE MONDE	CELA N A PAS DE FIN SI L ON DOIT ÉVITER TOUT LE MONDE	_
LA TOURTERELLE MÂLE	LA TOURTERELLE MÂLE	_
