SCONJ ADP NOUN	SCONJ ADP NOUN	_
AUX PART NOUN NOUN	AUX PART NOUN NOUN	_
DET NOUN ADP ADJ NOUN	DET NOUN ADP ADJ NOUN	_
PROPN ADJ NOUN	PROPN ADJ NOUN	_
PRON VERB ADV NOUN	PRON VERB ADV NOUN	_
PRON ADJ NOUN	PRON ADJ NOUN	_
PRON DET NOUN	DET NOUN <eps>	_
DET NOUN VERB NOUN	DET NOUN ADP NOUN	_
DET NOUN AUX ADJ	DET NOUN AUX ADJ	_
PROPN NOUN DET NOUN	PROPN ADJ NOUN <eps>	_
ADJ ADP NOUN	PROPN PROPN <eps>	_
PRON VERB NOUN	PRON VERB NOUN	_
PROPN VERB NOUN DET NOUN DET NOUN	PROPN VERB NOUN DET NOUN DET NOUN	_
VERB DET NOUN	VERB DET NOUN	_
ADP ADJ NOUN	ADP ADJ NOUN	_
VERB VERB PRON PRON	PRON NOUN VERB ADV	_
ADV AUX NOUN	ADV AUX NOUN	_
PRON VERB DET NOUN	PRON VERB DET NOUN	_
PRON ADP PRON AUX VERB ADV DET NOUN	PRON ADP PRON AUX VERB ADV DET NOUN	_
NOUN VERB ADJ NOUN	NOUN VERB ADJ NOUN	_
DET NOUN PRON PRON CCONJ NOUN	DET NOUN PRON PRON <eps> NOUN	_
PRON VERB VERB NOUN	PRON VERB VERB NOUN	_
NOUN ADV PRON VERB PRON ADV	NOUN ADV PRON VERB PRON ADV	_
NOUN ADP PROPN	VERB NOUN NOUN	_
NOUN CCONJ DET NOUN NOUN	NOUN CCONJ DET NOUN NOUN	_
PROPN ADJ ADP NOUN	PROPN ADJ ADP NOUN	_
PRON AUX VERB NOUN	DET ADJ NOUN <eps>	_
PRON ADJ NOUN	ADJ <eps> NOUN	_
PRON AUX DET NOUN	PRON AUX DET NOUN	_
NOUN AUX ADV	NOUN AUX ADV	_
PRON AUX ADV NOUN	PRON VERB DET NOUN	_
ADP VERB PRON	ADP VERB PRON	_
DET NOUN VERB DET ADJ	DET NOUN VERB DET ADJ	_
PRON AUX ADJ NOUN	PRON AUX ADJ NOUN	_
ADP ADJ ADJ NOUN	ADP ADJ ADJ NOUN	_
ADP PROPN ADV PRON VERB ADV	ADP PROPN ADV PRON VERB ADV	_
DET NOUN ADP NOUN ADP NOUN	DET NOUN ADP NOUN ADP NOUN	_
ADJ PROPN ADJ PROPN	ADV VERB ADP NOUN	_
DET NOUN AUX ADV	NOUN PRON CCONJ NOUN	_
AUX VERB ADP AUX NOUN NOUN	AUX VERB ADP AUX NOUN NOUN	_
PROPN VERB DET NOUN	PROPN VERB DET NOUN	_
DET ADJ NOUN	DET ADJ NOUN	_
ADP DET NOUN PRON ADV PRON VERB	ADP ADP NOUN PRON ADV PRON VERB	_
ADP NOUN ADJ ADP NOUN	ADV VERB ADJ DET NOUN	_
NOUN VERB PRON DET NOUN	NOUN VERB PRON DET NOUN	_
NOUN VERB DET NOUN	NOUN VERB DET NOUN	_
DET NOUN ADP NOUN	DET NOUN ADP NOUN	_
PRON AUX NOUN	PRON AUX NOUN	_
PRON VERB NOUN	PRON VERB NOUN	_
NOUN PROPN VERB	NOUN PROPN VERB	_
NOUN ADP PRON NOUN	NOUN ADP PRON NOUN	_
PROPN AUX NOUN NOUN	PROPN AUX NOUN NOUN	_
AUX AUX PART VERB ADP NOUN ADP NOUN NOUN	AUX AUX PART VERB ADP NOUN ADP NOUN NOUN	_
NOUN AUX NOUN NOUN NOUN	PRON <eps> CCONJ ADJ NOUN	_
PRON PRON AUX ADV ADJ	PRON PRON AUX ADV ADJ	_
ADV PRON AUX NOUN	ADV PRON AUX NOUN	_
PROPN AUX NOUN NOUN NOUN <eps>	<eps> ADJ NOUN ADP PROPN PROPN	_
ADP DET ADJ NOUN	ADP DET ADJ NOUN	_
NOUN ADP NOUN ADP PROPN	ADP NOUN <eps> NOUN PROPN	_
DET ADJ NOUN	DET ADJ NOUN	_
DET AUX NOUN	DET AUX NOUN	_
PRON VERB DET NOUN	PRON VERB DET NOUN	_
DET NOUN AUX ADJ NOUN	DET NOUN AUX ADJ NOUN	_
PROPN VERB NOUN NOUN	PROPN VERB NOUN NOUN	_
ADV NOUN AUX AUX NOUN	ADV NOUN AUX AUX NOUN	_
PRON ADP PRON ADP ADV ADP NOUN	PRON ADP PRON ADP NOUN ADP NOUN	_
PRON ADP ADP PROPN	PRON ADP ADP PROPN	_
ADP NOUN VERB ADJ NOUN	ADP PROPN VERB ADJ NOUN	_
ADV ADJ NOUN	ADV ADJ NOUN	_
PRON ADV NOUN	PRON AUX ADJ	_
AUX DET NOUN	AUX DET NOUN	_
ADJ NOUN NOUN	NOUN <eps> PROPN	_
AUX VERB VERB NOUN	AUX VERB VERB NOUN	_
PROPN AUX DET NOUN	PROPN AUX DET NOUN	_
ADJ AUX PROPN	ADJ AUX PROPN	_
PROPN CCONJ NOUN	NOUN ADP NOUN	_
DET NOUN NOUN	DET NOUN NOUN	_
NOUN CCONJ CCONJ NOUN PROPN	NOUN ADP ADP NOUN PROPN	_
PROPN PRON ADJ NOUN	PROPN PRON ADJ NOUN	_
ADP PROPN PRON AUX DET NOUN	ADP PROPN PRON VERB DET NOUN	_
ADP NOUN CCONJ NOUN	ADP NOUN NOUN ADJ	_
PROPN VERB ADP NOUN	PROPN VERB ADP NOUN	_
PROPN PROPN NOUN ADP PROPN	PROPN VERB NOUN ADP PROPN	_
PROPN ADJ ADJ	VERB <eps> ADJ	_
DET AUX NOUN VERB DET NOUN	PRON AUX NOUN <eps> <eps> <eps>	_
PRON AUX DET NOUN	PRON AUX DET NOUN	_
NOUN AUX PROPN NOUN	NOUN PROPN <eps> <eps>	_
NOUN ADP PROPN PROPN	NOUN ADP PROPN PROPN	_
CCONJ ADJ ADP DET NOUN	CCONJ ADJ ADP DET NOUN	_
ADV AUX NOUN ADJ	ADV AUX NOUN ADJ	_
PRON PRON VERB	ADP DET NOUN	_
AUX PRON VERB VERB PRON	AUX AUX ADV VERB PRON	_
NOUN ADP DET NOUN	NOUN ADP DET NOUN	_
NOUN AUX AUX NOUN	NOUN AUX AUX NOUN	_
PRON PRON VERB DET NOUN	PRON PRON VERB DET NOUN	_
AUX AUX ADJ NOUN	AUX AUX ADJ NOUN	_
PROPN AUX NOUN ADV	PROPN AUX NOUN ADV	_
AUX AUX NOUN ADV PRON	AUX VERB VERB ADP PRON	_
PRON VERB AUX PRON NOUN	PRON VERB AUX PRON NOUN	_
PRON PRON VERB ADJ ADP NOUN NOUN	PRON PRON VERB ADJ ADP NOUN NOUN	_
ADV VERB ADP NOUN ADP NOUN	NOUN VERB ADP NOUN ADP NOUN	_
AUX VERB ADV PRON NOUN ADP NOUN	AUX VERB ADV PRON NOUN ADP NOUN	_
VERB DET ADJ NOUN NOUN	ADJ NOUN NOUN <eps> <eps>	_
DET NOUN VERB NOUN	DET NOUN VERB NOUN	_
ADP SCONJ PRON VERB	ADP SCONJ PRON VERB	_
DET NOUN ADP NOUN ADP NOUN DET NOUN	DET NOUN ADP NOUN ADP NOUN ADP NOUN	_
ADV AUX ADJ NOUN	PROPN AUX DET NOUN	_
ADV AUX VERB SCONJ PRON VERB	ADV AUX VERB SCONJ PRON VERB	_
NOUN DET NOUN	ADJ PROPN VERB	_
PRON PRON VERB DET NOUN ADJ NOUN	PRON PRON VERB DET NOUN ADJ NOUN	_
ADJ NOUN ADP NOUN <eps>	ADJ NOUN ADP DET NOUN	_
ADP PRON DET NOUN	ADP PRON PRON VERB	_
<eps> DET ADJ NOUN	VERB DET NOUN <eps>	_
NOUN NOUN ADP DET PRON NOUN	NOUN NOUN ADP DET PRON NOUN	_
ADP ADJ NOUN PRON VERB NOUN	PROPN NOUN DET NOUN NOUN NOUN	_
NOUN DET ADJ NOUN	NOUN DET ADJ NOUN	_
PRON VERB PRON VERB	PRON VERB PRON VERB	_
PROPN ADP NOUN	NOUN ADP NOUN	_
PRON VERB VERB PRON ADV	PRON VERB VERB PRON ADV	_
CCONJ ADP NOUN ADP NOUN	PRON NOUN <eps> DET NOUN	_
PROPN AUX DET NOUN NOUN ADP NOUN	PROPN AUX DET NOUN NOUN ADP NOUN	_
ADJ ADP PRON PRON VERB	ADJ ADP PRON PRON VERB	_
PRON PRON VERB DET NOUN ADP NOUN	PRON PRON VERB DET NOUN ADP NOUN	_
DET AUX CCONJ NOUN	DET AUX CCONJ NOUN	_
ADV PRON NOUN <eps> VERB ADJ	VERB VERB AUX ADJ NOUN NOUN	_
ADP PRON PRON VERB PRON	ADP PRON PRON VERB PRON	_
NOUN VERB PROPN NOUN	NOUN VERB PROPN NOUN	_
DET NOUN AUX NOUN	DET NOUN AUX NOUN	_
ADP AUX NOUN	ADP AUX NOUN	_
PRON AUX ADJ NOUN VERB ADV	PRON AUX ADJ NOUN VERB ADV	_
ADV AUX ADV ADV	ADV AUX ADV ADV	_
DET NOUN NOUN	DET NOUN NOUN	_
PRON VERB ADJ NOUN	PRON VERB VERB NOUN	_
ADV VERB VERB ADP DET NOUN	ADV VERB VERB ADP DET NOUN	_
DET NOUN CCONJ NOUN	DET NOUN CCONJ NOUN	_
X NOUN ADJ ADJ NOUN	AUX NOUN <eps> ADJ NOUN	_
PRON PRON AUX NOUN	VERB <eps> <eps> NOUN	_
PRON VERB DET NOUN NOUN	PRON VERB DET NOUN NOUN	_
AUX ADP NOUN ADV	AUX ADP NOUN ADV	_
PRON VERB NOUN	PRON VERB NOUN	_
PRON ADV PRON VERB NOUN	PRON ADV PRON VERB NOUN	_
DET ADJ AUX NOUN	DET ADJ AUX NOUN	_
PRON VERB DET ADJ NOUN	PRON VERB DET ADJ NOUN	_
AUX ADV VERB ADJ ADJ NOUN	AUX ADV VERB ADJ ADJ NOUN	_
NOUN DET NOUN NOUN	NOUN DET VERB NOUN	_
PRON AUX PRON SCONJ PRON AUX PROPN	PRON AUX PRON SCONJ PRON AUX PROPN	_
VERB NUM NOUN	VERB NUM NOUN	_
PRON ADV AUX ADJ ADP PRON	PRON ADV AUX ADJ ADP PRON	_
PRON PRON AUX ADJ ADJ	PRON PRON AUX ADJ ADJ	_
PROPN AUX ADJ NOUN	PROPN AUX ADJ NOUN	_
PRON PRON VERB NOUN	PRON PRON VERB NOUN	_
PROPN AUX DET NOUN	PROPN AUX DET NOUN	_
ADP NOUN PRON NOUN	ADP NOUN PRON NOUN	_
VERB ADJ NOUN	NOUN ADJ NOUN	_
PRON VERB PRON VERB	PRON VERB PRON VERB	_
AUX VERB VERB ADJ ADJ NOUN	AUX PRON AUX ADJ ADJ NOUN	_
NOUN DET NOUN	NOUN DET NOUN	_
CCONJ DET NOUN VERB DET NOUN	PRON AUX NOUN VERB DET NOUN	_
PRON VERB ADP DET NOUN	PRON VERB ADP DET NOUN	_
DET NOUN ADP DET NOUN VERB NOUN	DET NOUN ADP DET NOUN VERB NOUN	_
DET NOUN NOUN	DET NOUN NOUN	_
ADV VERB PRON ADJ DET NOUN	ADV VERB PRON PRON DET NOUN	_
PROPN VERB PROPN <eps>	PROPN ADP ADJ NOUN	_
PRON ADV DET NOUN	PRON ADV DET NOUN	_
ADV PRON AUX DET ADJ NOUN	ADV PRON AUX DET ADJ NOUN	_
PRON AUX ADJ NOUN ADP DET NOUN NOUN	PRON <eps> VERB NOUN ADP DET NOUN NOUN	_
PROPN VERB ADJ NOUN	PROPN VERB ADJ NOUN	_
ADP NOUN ADP PROPN	ADP NOUN ADP PROPN	_
ADV AUX NOUN NOUN ADP PROPN	ADV <eps> PROPN VERB DET NOUN	_
NOUN VERB DET NOUN	NOUN VERB DET NOUN	_
NOUN NOUN ADP DET NOUN	PROPN PROPN ADP CCONJ NOUN	_
SCONJ DET NOUN AUX ADV ADP ADJ NOUN	SCONJ DET NOUN VERB ADJ ADP DET NOUN	_
PRON NOUN ADP NOUN ADP NOUN ADJ	PRON NOUN ADP NOUN ADP NOUN ADJ	_
AUX NOUN ADP NOUN	AUX ADJ NOUN <eps>	_
ADP DET ADJ NOUN	ADP DET ADJ NOUN	_
ADJ NOUN ADP DET NOUN	ADJ NOUN ADP DET NOUN	_
PROPN DET NOUN	PROPN DET NOUN	_
NOUN PRON PRON AUX ADV	NOUN PRON PRON AUX ADV	_
PRON VERB ADV DET NOUN	PRON VERB ADV DET NOUN	_
AUX VERB VERB VERB NOUN	AUX VERB VERB ADJ <eps>	_
PRON VERB DET NOUN ADJ	PRON VERB DET NOUN ADJ	_
NOUN ADP NOUN NOUN NOUN ADP NOUN	NOUN ADP NOUN NOUN NOUN ADP NOUN	_
DET ADJ ADJ	DET ADJ ADJ	_
ADV VERB NOUN NOUN	ADV VERB ADJ NOUN	_
PRON DET NOUN	PRON DET NOUN	_
DET AUX NOUN	DET AUX NOUN	_
PROPN AUX ADJ NOUN	PROPN AUX ADJ NOUN	_
PRON ADV PRON NOUN ADP PROPN	PRON ADV PRON NOUN ADP PROPN	_
PRON VERB ADV DET NOUN	PRON VERB ADV DET NOUN	_
VERB NOUN PRON NOUN	VERB VERB PRON NOUN	_
PRON AUX ADV NOUN	PRON AUX ADJ NOUN	_
PROPN NOUN NOUN	PROPN <eps> <eps>	_
ADJ VERB ADP	NOUN ADP NOUN	_
PROPN VERB DET NOUN	PROPN VERB DET NOUN	_
VERB PRON ADP DET NOUN	VERB PRON ADP DET NOUN	_
PROPN AUX NOUN	PROPN AUX NOUN	_
ADJ NOUN ADP NOUN	ADJ NOUN ADP NOUN	_
ADV AUX DET NOUN DET NOUN	AUX AUX DET NOUN DET NOUN	_
AUX PRON NOUN DET NOUN	AUX PRON NOUN DET NOUN	_
NOUN AUX NOUN	NOUN AUX ADJ	_
NOUN PROPN PROPN NOUN	NOUN PROPN PROPN NOUN	_
DET AUX NOUN	DET AUX NOUN	_
PRON VERB VERB	PRON VERB VERB	_
ADJ DET NOUN AUX ADP NOUN NOUN	ADV DET NOUN AUX ADP NOUN NOUN	_
DET NOUN ADP NOUN	DET NOUN ADP NOUN	_
PRON PRON AUX ADV ADP DET NOUN	PRON NOUN AUX ADV <eps> ADJ NOUN	_
PRON VERB SCONJ NOUN	ADP NOUN <eps> <eps>	_
PROPN NOUN ADV AUX ADV ADV	PROPN NOUN ADV AUX ADV ADV	_
X AUX ADJ VERB DET DET NOUN	X AUX ADJ VERB DET DET NOUN	_
DET PROPN PROPN	DET PROPN PROPN	_
DET NOUN ADJ NOUN NOUN	DET NOUN ADJ NOUN NOUN	_
NOUN ADP NOUN ADV	DET <eps> NOUN NOUN	_
DET NOUN AUX ADJ NOUN	DET NOUN AUX ADJ NOUN	_
PROPN PROPN VERB VERB DET NOUN	PROPN ADJ VERB VERB DET NOUN	_
DET NOUN AUX NOUN	DET NOUN AUX NOUN	_
DET NOUN NOUN	DET NOUN NOUN	_
PROPN NOUN ADV PROPN ADP DET NOUN	NOUN PRON PRON VERB ADP DET NOUN	_
AUX VERB ADP DET NOUN	AUX VERB ADP DET NOUN	_
PRON PRON VERB	PRON PRON VERB	_
ADP ADJ NOUN	ADP ADJ NOUN	_
AUX ADP CCONJ NOUN	AUX ADP CCONJ NOUN	_
DET NOUN DET ADJ NOUN	DET NOUN DET ADJ NOUN	_
PRON AUX VERB SCONJ PRON VERB DET NOUN	PRON AUX VERB SCONJ PRON VERB DET NOUN	_
ADP PROPN ADJ NOUN	ADP PROPN ADJ NOUN	_
PROPN DET ADJ NOUN <eps>	PROPN AUX NOUN ADP NOUN	_
DET NOUN VERB DET VERB ADV	DET NOUN NOUN AUX VERB ADV	_
ADV ADJ VERB <eps>	ADV ADP ADP NOUN	_
DET NOUN DET NOUN	DET NOUN DET NOUN	_
AUX PRON ADP ADJ NOUN	AUX PRON ADP ADJ NOUN	_
NOUN PROPN NOUN NOUN	NOUN PROPN NOUN NOUN	_
PRON VERB ADJ NOUN	PRON VERB ADJ NOUN	_
DET NOUN VERB ADP VERB DET NOUN	DET NOUN VERB ADP VERB DET NOUN	_
PRON PRON VERB ADV DET NOUN ADP DET NOUN	PRON PRON VERB ADV DET NOUN ADP DET NOUN	_
DET VERB ADJ	DET VERB ADJ	_
DET NOUN NOUN	DET NOUN NOUN	_
PROPN AUX DET NOUN	PROPN AUX DET NOUN	_
NOUN ADP NOUN <eps> DET NOUN VERB ADP DET NOUN	NOUN ADP DET NOUN DET NOUN VERB ADP DET NOUN	_
PRON AUX PRON SCONJ AUX VERB	PRON AUX PRON SCONJ AUX VERB	_
ADP NOUN DET NOUN	ADP NOUN DET NOUN	_
DET NOUN VERB PRON	DET NOUN VERB PRON	_
VERB DET ADJ NOUN	VERB PRON ADJ NOUN	_
DET NOUN AUX DET ADJ NOUN	DET NOUN AUX DET ADJ NOUN	_
PRON PRON VERB CCONJ ADJ	PRON PRON VERB CCONJ ADJ	_
PRON AUX NOUN ADP NOUN	PRON AUX NOUN ADP NOUN	_
PROPN ADJ NOUN	PROPN ADJ NOUN	_
NOUN DET NOUN PROPN	NOUN DET NOUN NOUN	_
PRON NOUN AUX VERB ADJ NOUN	PRON NOUN AUX VERB ADJ NOUN	_
ADP NOUN VERB	ADP NOUN VERB	_
ADP NOUN VERB ADJ NOUN	ADP NOUN VERB ADJ NOUN	_
NOUN NOUN PRON AUX DET NOUN	NOUN NOUN PRON AUX DET NOUN	_
NOUN PRON AUX NOUN DET NOUN	NOUN PRON AUX NOUN DET NOUN	_
NOUN ADP NOUN ADP NOUN	NOUN ADP NOUN ADP NOUN	_
PROPN NOUN AUX PRON NOUN	PROPN NOUN AUX PRON NOUN	_
PRON AUX VERB DET NOUN	PRON AUX VERB DET NOUN	_
PRON AUX PRON VERB DET NOUN	AUX VERB VERB NOUN DET NOUN	_
PRON AUX VERB ADP NOUN	PRON AUX VERB ADP NOUN	_
NOUN AUX AUX VERB DET NOUN	NOUN AUX AUX VERB DET NOUN	_
PRON NOUN ADV NOUN ADP PRON NOUN	PRON NOUN ADV NOUN ADP PRON NOUN	_
NOUN ADP VERB NOUN <eps>	NOUN VERB ADP DET NOUN	_
PRON NOUN VERB PRON ADP NOUN	PRON NOUN AUX ADJ DET NOUN	_
DET ADJ NOUN ADV VERB AUX NOUN	DET ADJ NOUN ADV VERB AUX NOUN	_
ADP ADJ NOUN CCONJ NOUN NOUN NOUN	DET <eps> NOUN <eps> ADJ NOUN <eps>	_
PRON AUX VERB ADJ	PRON AUX VERB ADJ	_
NOUN ADP PROPN	NOUN ADP PROPN	_
ADJ VERB DET NOUN ADP PROPN	ADJ VERB DET NOUN ADP PROPN	_
PRON VERB ADP DET ADJ NOUN	PROPN VERB ADP DET ADJ NOUN	_
DET NOUN AUX ADJ <eps>	PRON VERB ADV ADJ NOUN	_
NOUN NOUN NOUN AUX DET NOUN ADP PROPN	NOUN NOUN NOUN AUX DET NOUN ADP PROPN	_
PRON VERB CCONJ ADJ NOUN	PRON VERB CCONJ ADJ NOUN	_
PRON PRON ADP DET ADJ NOUN	PRON PRON ADP DET ADJ NOUN	_
ADV ADP NOUN ADP PROPN NOUN	ADV ADP NOUN ADP PROPN NOUN	_
ADV VERB PRON ADP NOUN	ADV VERB DET NOUN ADV	_
NOUN DET PRON VERB	NOUN DET PRON VERB	_
PROPN AUX DET NOUN ADP NUM NOUN	PROPN AUX DET NOUN ADP NUM NOUN	_
PRON AUX VERB VERB ADJ ADP NOUN	PRON AUX VERB VERB ADJ ADP NOUN	_
PROPN AUX NOUN	DET NOUN <eps>	_
PROPN AUX NOUN PRON DET NOUN	PROPN AUX NOUN PRON DET NOUN	_
PRON VERB ADV	ADJ NOUN PROPN	_
PRON AUX ADV PRON SCONJ PRON VERB ADP NOUN	PRON AUX ADV PRON SCONJ PRON VERB ADP NOUN	_
CCONJ AUX VERB DET ADJ NOUN	CCONJ AUX VERB DET ADJ NOUN	_
NOUN SCONJ PROPN	NOUN SCONJ PROPN	_
PRON AUX NOUN DET NOUN	PRON AUX NOUN DET NOUN	_
PRON AUX DET ADJ NOUN	ADV AUX DET NOUN NOUN	_
PRON AUX VERB DET NOUN	PRON AUX VERB DET NOUN	_
NOUN CCONJ ADV	ADJ DET NOUN	_
PRON PRON ADP DET NOUN ADP NOUN	PRON PRON ADP DET NOUN ADP NOUN	_
NOUN PRON VERB ADV VERB NOUN	PRON AUX VERB ADJ NOUN <eps>	_
DET NOUN ADP NOUN	DET NOUN ADP NOUN	_
ADV VERB AUX NOUN SCONJ PRON ADP PRON ADP NOUN ADP NOUN	NOUN <eps> <eps> <eps> NOUN PRON ADP ADP <eps> NOUN ADP NOUN	_
ADP NOUN DET NOUN	ADP NOUN DET NOUN	_
NOUN ADP PROPN	NOUN ADP PROPN	_
PROPN PROPN ADV VERB DET NOUN ADP	PROPN PROPN ADV VERB DET NOUN <eps>	_
NOUN ADJ ADJ NOUN	NOUN ADJ ADJ NOUN	_
NOUN VERB DET NOUN NOUN	NOUN VERB DET NOUN NOUN	_
AUX VERB ADJ ADV	AUX VERB ADJ ADV	_
PRON VERB ADJ NOUN ADP NOUN	PRON VERB ADJ NOUN ADP NOUN	_
PRON ADJ NOUN DET NOUN	PRON ADJ NOUN DET NOUN	_
PRON VERB ADV NOUN	PRON VERB ADV NOUN	_
PROPN AUX DET NOUN ADP NOUN	PROPN AUX DET NOUN ADP NOUN	_
AUX VERB AUX NOUN	AUX VERB AUX NOUN	_
PROPN VERB DET NOUN	PROPN VERB DET NOUN	_
DET NOUN AUX NOUN	DET NOUN AUX NOUN	_
AUX VERB SCONJ PRON ADJ VERB <eps> ADP DET PROPN	AUX VERB SCONJ PRON AUX DET NOUN ADP DET NOUN	_
NOUN NOUN NOUN	NOUN NOUN NOUN	_
NOUN PRON VERB ADP NOUN ADP ADJ NOUN	<eps> PRON AUX DET NOUN ADP NOUN <eps>	_
PRON AUX ADV PROPN ADJ NOUN	PRON AUX ADV PROPN ADJ NOUN	_
ADV ADV DET NOUN VERB	ADV ADV DET NOUN VERB	_
DET NOUN VERB DET NOUN AUX NOUN	DET NOUN ADP DET NOUN AUX NOUN	_
ADP PRON NOUN ADP DET NOUN	AUX DET NOUN ADP DET NOUN	_
NOUN AUX ADV NOUN	NOUN AUX ADV NOUN	_
PROPN NOUN DET PROPN DET ADP PROPN	PROPN NOUN DET PROPN ADP PROPN PROPN	_
PRON NOUN ADP NOUN ADP PRON NOUN PRON VERB ADP NOUN	NOUN NOUN CCONJ NOUN ADP <eps> <eps> PRON NOUN ADP NOUN	_
PROPN AUX ADJ ADP DET NOUN	PROPN AUX ADJ ADP DET NOUN	_
PRON VERB VERB SCONJ PRON VERB	PRON VERB VERB SCONJ PRON VERB	_
ADV ADV VERB DET NOUN	VERB ADP NOUN NOUN <eps>	_
VERB PRON NOUN	VERB ADP NOUN	_
NOUN AUX PRON SCONJ PRON VERB	VERB <eps> PRON SCONJ ADP VERB	_
NOUN DET NOUN PROPN DET NOUN	ADJ CCONJ ADJ NOUN DET NOUN	_
PRON VERB DET NOUN ADP DET NOUN	PRON VERB DET NOUN ADP DET NOUN	_
DET NOUN NOUN	DET NOUN NOUN	_
ADV PRON ADP NOUN	ADV PRON ADP NOUN	_
CCONJ NOUN PRON AUX NOUN	CCONJ NOUN PRON AUX NOUN	_
VERB ADJ NOUN	VERB ADJ NOUN	_
DET PROPN NOUN DET PROPN	DET PROPN NOUN CCONJ NOUN	_
PRON DET NOUN ADP ADJ NOUN	PRON DET NOUN ADP ADJ NOUN	_
NOUN DET ADJ NOUN ADP NOUN	NOUN ADP DET NOUN ADP NOUN	_
DET NOUN ADP NOUN	DET NOUN ADP NOUN	_
VERB AUX DET NOUN PRON	VERB VERB DET NOUN <eps>	_
DET NOUN VERB DET NOUN ADP NOUN	DET NOUN VERB DET NOUN ADP NOUN	_
ADP NOUN ADP NOUN NOUN	ADP NOUN ADP NOUN NOUN	_
ADV ADP AUX ADV DET NOUN NOUN	ADV ADP AUX ADV DET NOUN NOUN	_
DET NOUN NOUN	DET NOUN NOUN	_
NOUN ADJ NOUN	NOUN ADJ NOUN	_
DET NOUN DET NOUN NUM	DET NOUN DET NOUN NUM	_
NOUN NOUN AUX NOUN ADJ NOUN	NOUN NOUN AUX NOUN AUX NOUN	_
NOUN ADP NOUN PART NOUN CCONJ	NOUN ADP NOUN ADP NOUN <eps>	_
DET NOUN VERB DET NOUN	DET NOUN VERB DET NOUN	_
PRON VERB ADP DET NOUN CCONJ DET NOUN	PRON AUX VERB <eps> <eps> CCONJ DET NOUN	_
ADP DET ADJ NOUN	ADP DET ADJ NOUN	_
VERB PRON ADJ NOUN	VERB PRON ADJ NOUN	_
DET NOUN AUX ADJ	DET NOUN AUX ADJ	_
PRON ADV AUX NOUN	PRON ADV AUX NOUN	_
NOUN NOUN NOUN ADJ NOUN	NOUN NOUN NOUN ADJ NOUN	_
ADP DET NOUN PRON PRON ADP ADJ NOUN	ADP DET NOUN PRON PRON ADP ADJ NOUN	_
ADP DET NOUN	ADP DET NOUN	_
DET NOUN AUX NOUN	DET NOUN AUX NOUN	_
PRON PRON ADV ADV ADP NOUN	PRON PRON ADV ADV ADP NOUN	_
ADV ADV ADP VERB AUX DET NOUN	PROPN ADV VERB <eps> <eps> DET NOUN	_
VERB NOUN ADJ NOUN	VERB NOUN ADJ NOUN	_
PRON VERB ADV ADV DET NOUN PRON AUX ADV NOUN	PRON VERB ADV PRON ADV <eps> PRON AUX ADV NOUN	_
NOUN NOUN NOUN	DET NOUN NOUN	_
NOUN ADV PRON SCONJ PRON ADJ VERB	NOUN ADV PRON SCONJ PRON ADJ VERB	_
AUX DET NOUN NOUN	AUX DET NOUN NOUN	_
NOUN VERB DET NOUN	NOUN VERB DET NOUN	_
PRON AUX NOUN ADP DET NOUN	PRON AUX NOUN ADP DET NOUN	_
NOUN ADP DET NOUN	NOUN ADP DET NOUN	_
PRON VERB DET ADJ NOUN	PRON VERB DET ADJ NOUN	_
ADP NOUN VERB DET NOUN	PROPN NOUN VERB DET NOUN	_
PRON NOUN ADP DET VERB ADP NOUN NOUN	PRON NOUN ADP DET VERB ADP NOUN NOUN	_
PROPN NOUN AUX PRON NOUN	DET NOUN ADJ NOUN <eps>	_
ADP NOUN AUX NOUN	ADP NOUN AUX NOUN	_
NOUN ADP NOUN	NOUN ADP NOUN	_
ADP NOUN ADJ NOUN NOUN	ADP NOUN VERB NOUN NOUN	_
VERB NOUN DET NOUN PRON ADV VERB NOUN	VERB NOUN DET NOUN PRON ADV VERB NOUN	_
ADJ PRON ADJ VERB	ADJ PRON ADJ VERB	_
DET NOUN NOUN	DET NOUN NOUN	_
PRON VERB ADP NOUN ADP NOUN	PRON NOUN ADP NOUN NOUN <eps>	_
PROPN PROPN NOUN	NOUN ADJ NOUN	_
DET NOUN AUX PRON NOUN	PRON NOUN AUX PRON NOUN	_
PRON PRON PRON NOUN	PRON PRON PRON NOUN	_
VERB PROPN DET NOUN	VERB PROPN DET NOUN	_
VERB ADJ NOUN VERB PRON	CCONJ ADJ VERB ADP NOUN	_
NOUN DET NOUN	NOUN DET NOUN	_
DET NOUN ADJ	DET ADJ NOUN	_
DET NOUN ADJ NOUN	DET NOUN ADJ NOUN	_
NOUN ADP PRON VERB NOUN	NOUN ADP PRON VERB NOUN	_
VERB ADV NOUN ADP ADV PRON NOUN	ADJ <eps> NOUN ADP NOUN PRON NOUN	_
PRON AUX VERB ADP DET ADJ NOUN	PRON AUX VERB ADP DET ADJ NOUN	_
PRON AUX ADJ	PRON AUX ADJ	_
ADV VERB PRON ADJ ADP NOUN	ADV VERB PRON ADJ ADP NOUN	_
DET NOUN NOUN	DET NOUN NOUN	_
AUX VERB NOUN ADP ADJ DET NOUN	AUX VERB NOUN <eps> VERB DET NOUN	_
PRON PRON CCONJ DET NOUN <eps> ADJ NOUN	PRON PRON VERB DET NOUN ADP ADJ NOUN	_
SCONJ PRON VERB ADP NOUN ADP DET NOUN	SCONJ PRON VERB ADP NOUN ADP DET NOUN	_
PRON VERB NOUN DET NOUN DET NOUN	PRON VERB NOUN DET NOUN DET NOUN	_
NOUN ADJ ADJ	NOUN ADJ ADJ	_
PRON VERB ADP DET NOUN ADP DET NOUN DET NOUN	PRON VERB ADP DET NOUN ADP DET NOUN DET NOUN	_
PRON VERB SCONJ PRON VERB ADV	PRON VERB SCONJ PRON VERB ADV	_
DET NOUN ADP NOUN	DET NOUN ADP NOUN	_
NOUN VERB ADP NOUN <eps> <eps>	PRON VERB ADP NOUN ADP NOUN	_
ADV VERB DET NOUN VERB NOUN	ADV VERB DET NOUN VERB NOUN	_
PRON AUX PRON SCONJ PRON VERB NOUN	PRON AUX PRON SCONJ PRON VERB NOUN	_
NOUN ADP NOUN ADP PROPN	NOUN PROPN <eps> ADP NOUN	_
DET NOUN PRON VERB	DET NOUN PRON VERB	_
DET NOUN VERB DET NOUN	PRON AUX VERB DET NOUN	_
PROPN PRON AUX ADV ADP NOUN PRON PRON ADP ADV VERB ADV DET NOUN	PROPN PRON AUX ADV ADP NOUN PRON PRON ADP PRON VERB PRON DET NOUN	_
DET NOUN NOUN	DET NOUN NOUN	_
