SCONJ ADP NOUN	QUE D EAU	QUE D EAU	_
AUX PART NOUN NOUN	JE NE ROUGIS PAS	JE NE ROUGE PAS	_
DET NOUN ADP ADJ NOUN	IL BOIT DE L EAU	IL BOIT DE L EAU	_
PROPN ADJ NOUN	C EST SALE	C EST SALE	_
PRON VERB ADV NOUN	NE L ÉTANT PAS	NE L ÉTANT PAS	_
PRON ADJ NOUN	NOS TROIS FEUILLES	NOS TROIS FEUILLES	_
PRON DET NOUN	IL A RAISON	IL HARISSANT <eps>	_
DET NOUN VERB NOUN	LE TEMPS SERA CHAUD	LE TRANSFERT À CHAUD	_
DET NOUN AUX ADJ	LA MAISON EST GRANDE	LA MAISON EST GRANDE	_
PROPN NOUN DET NOUN	NEUF HEURES ET QUART	NEUF HEURES ÉCARTS <eps>	_
ADJ ADP NOUN	TOUT EN FINESSE	CHARLES FÉNIS <eps>	_
PRON VERB NOUN	NE PLEURE PAS	NE PLEURE PAS	_
PROPN VERB NOUN DET NOUN DET NOUN	C EST BON DE MANGER DU LAIT	C EST BON DE MANGER DU LAIT	_
VERB DET NOUN	DANS TA CHAMBRE	DANS TA CHAMBRE	_
ADP ADJ NOUN	C EST JOLI	C EST JOLI	_
VERB VERB PRON PRON	HI HI HI HI	IL FIT QU ICI	_
ADV AUX NOUN	QUI T ACCOMPAGNE	QUI T ACCOMPAGNE	_
PRON VERB DET NOUN	C EST VOTRE OPINION	C EST VOTRE OPINION	_
PRON ADP PRON AUX VERB ADV DET NOUN	IL N Y A PAS BEAUCOUP DE MONDE	IL N Y A PAS BEAUCOUP DE MONDE	_
NOUN VERB ADJ NOUN	COMMENT VA VOTRE SŒUR	COMMENT VA VOTRE SŒUR	_
DET NOUN PRON PRON CCONJ NOUN	IL FAUT QUE J Y ARRIVE	IL FAUT QUE J <eps> ARRIVE	_
PRON VERB VERB NOUN	CE SERAIT TROP LENT	CE SERAIT TROP LENT	_
NOUN ADV PRON VERB PRON ADV	POURQUOI N Y ALLEZ VOUS PAS	POURQUOI N Y ALLEZ VOUS PAS	_
NOUN ADP PROPN	VAS T EN	VA T EN	_
NOUN CCONJ DET NOUN NOUN	VINGT ET UN LIVRES NOIRS	VINGT ET UN LIVRES NOIRS	_
PROPN ADJ ADP NOUN	C EST COMME ÇA	C EST COMME ÇA	_
PRON AUX VERB NOUN	NE M ATTAQUEZ PAS	NE METTAQUEZ PART <eps>	_
PRON ADJ NOUN	VOUS ÊTES PRÊT	VEUT <eps> PRÊT	_
PRON AUX DET NOUN	C EST LA RÉALITÉ	C EST LA RÉALITÉ	_
NOUN AUX ADV	ELLE EST BIEN	ELLE EST BIEN	_
PRON AUX ADV NOUN	ELLES VONT TRÈS BIEN	ELLE VEND TRÈS BIEN	_
ADP VERB PRON	OÙ SUIS JE	OÙ SUIS JE	_
DET NOUN VERB DET ADJ	LE PLUS QU IL PEUT	LE PLUS QU IL PEUT	_
PRON AUX ADJ NOUN	ÇA M EST ÉGAL	ÇA M EST ÉGAL	_
ADP ADJ ADJ NOUN	C EST COMBIEN ÇA	C EST COMBIEN ÇA	_
ADP PROPN ADV PRON VERB ADV	L OISEAU QUI NE CHANTE PLUS	L OISEAU QUI NE CHANTE PLUS	_
DET NOUN ADP NOUN ADP NOUN	UNE TRENTAINE DE KILOS DE BANANES	UNE TRENTAINE DE PHILOS DE BANANE	_
ADJ PROPN ADJ PROPN	SURTOUT PARMI VOS AMIS	SURTOUT PARMI AUX AMIS	_
DET NOUN AUX ADV	QUEL ÂGE ONT ILS	QU IL A GENTIL	_
AUX VERB ADP AUX NOUN NOUN	MA FILLE N EST PAS ICI	MA FILLE N EST PAS ICI	_
PROPN VERB DET NOUN	C EST UNE ÉVIDENCE	C EST UNE ÉVIDENCE	_
DET ADJ NOUN	LA DIX HUITIÈME	LA DIX HUITIÈME	_
ADP DET NOUN PRON ADV PRON VERB	À QUELLE HEURE VOUS ÊTES VOUS LEVÉ	À QU HEURE VOUS ÊTES VOUS LEVÉ	_
ADP NOUN ADJ ADP NOUN	J ACCEPTAI TOUT DE SUITE	J ACCEPTAIT TOUT DE SUITE	_
NOUN VERB PRON DET NOUN	COMMENT VA TOUT LE MONDE	COMMENT VA TOUT LE MONDE	_
NOUN VERB DET NOUN	ELLE VA ME TAPER	ELLE VA ME TAPER	_
DET NOUN ADP NOUN	LE MORCEAU DE PAIN	LE MORCEAU DE PAIN	_
PRON AUX NOUN	IL EST CHAUD	IL EST CHAUD	_
PRON VERB NOUN	IL ARRIVE BIENTÔT	IL ARRIVE BIENTÔT	_
NOUN PROPN VERB	ELLE ELLE AIMAIT	ELLE ELLE AIMAIT	_
NOUN ADP PRON NOUN	IMPOSSIBLE DE ME RAPPELER	IMPOSSIBLE DE ME RAPPELER	_
PROPN AUX NOUN NOUN	C EST TROP GRAND	C EST TROP GRAND	_
AUX AUX PART VERB ADP NOUN ADP NOUN NOUN	ON M A DIT D ALLER À L ÉCOLE	ON M A DIT D ALLER À L ÉCOLE	_
NOUN AUX NOUN NOUN NOUN	C EST MA SŒUR AÎNÉE	CES <eps> MA SŒURS AÎNÉES	_
PRON PRON AUX ADV ADJ	IL N EST PAS MAUVAIS	IL N EST PAS MAUVAIS	_
ADV PRON AUX NOUN	MAIS IL EST PARTI	MAIS IL EST PARTI	_
PROPN AUX NOUN NOUN NOUN <eps>	C EST SIGNÉ DIDIER MIGAUD <eps>	<eps> EST SIGNÉ D ITIE MIGO	_
ADP DET ADJ NOUN	À LA BONNE HEURE	À LA BONNE HEURE	_
NOUN ADP NOUN ADP PROPN	D OÙ VIENT L ARGENT	D OÙVIENT <eps> L ARGENT	_
DET ADJ NOUN	LE BEAU TEMPS	LE BEAU TEMPS	_
DET AUX NOUN	IL EST TEMPS	IL EST TEMPS	_
PRON VERB DET NOUN	VOUS VENEZ CE SOIR	VOUS VENEZ CE SOIR	_
DET NOUN AUX ADJ NOUN	LE PARTI ÉTAIT BIEN MALADE	LE PARTI ÉTAIT BIEN MALADE	_
PROPN VERB NOUN NOUN	C EST TON TOUR	C EST TON TOUR	_
ADV NOUN AUX AUX NOUN	ELLES ELLES ONT ÉTÉ AIMÉES	ELLES ELLES ONT ÉTÉ AIMÉES	_
PRON ADP PRON ADP ADV ADP NOUN	IL N Y A PAS DE CHAISES	IL N Y A PAS DE CHAISE	_
PRON ADP ADP PROPN	IL Y EN A	IL Y EN A	_
ADP NOUN VERB ADJ NOUN	L AFFAIRE FIT GRAND BRUIT	L AFFAIRE FAIT GRAND BRUIT	_
ADV ADJ NOUN	AUCUNE AUTRE CHAISE	AUCUNE AUTRE CHAISE	_
PRON ADV NOUN	VOUS ÊTES FATIGUÉES	VOUS ÊTES FATIGUÉ	_
AUX DET NOUN	ON A AIMÉ	ON A AIMÉ	_
ADJ NOUN NOUN	LAISSE MOI TRANQUILLE	LAISSEMENT <eps> TRANQUILLE	_
AUX VERB VERB NOUN	ON DÉPLACE L ÉQUILIBRE	ON DÉPLACE L ÉQUILIBRE	_
PROPN AUX DET NOUN	C EST UNE MAISON	C EST UNE MAISON	_
ADJ AUX PROPN	TU ES ICI	TU ES ICI	_
PROPN CCONJ NOUN	GARÇON OU FILLE	GARÇONS AUX FILLES	_
DET NOUN NOUN	DES JOUEURS VIOLENTS	DES JOUEURS VIOLENTS	_
NOUN CCONJ CCONJ NOUN PROPN	QUI Y A T IL	QU Y A T IL	_
PROPN PRON ADJ NOUN	JEAN NOUS SOMMES VOISINS	JEAN NOUS SONGS VOISINS	_
ADP PROPN PRON AUX DET NOUN	POUR EUX CE SERAIT UNE AIDE	POUR EUX CE SERAIT UNE ÊTRE	_
ADP NOUN CCONJ NOUN	L ORAGE A REDOUBLÉ	L ORAGE ARRIVE DEMEURE	_
PROPN VERB ADP NOUN	ELLE CHANGEA DE COULEUR	ELLE CHANGEA DE COULEUR	_
PROPN PROPN NOUN ADP PROPN	MADAME EST ALLÉE À PARIS	MADAME EST ALLÉ À PARIS	_
PROPN ADJ ADJ	C EST EXACT	PEUT <eps> EXACT	_
DET AUX NOUN VERB DET NOUN	IL EST TEMPS D Y ALLER	IL EST ENDIAL <eps> <eps> <eps>	_
PRON AUX DET NOUN	IL EST DE SUPPRESSION	IL EST DE SUPPRESSION	_
NOUN AUX PROPN NOUN	MOI J AI AIMÉ	MOI JAMAIS <eps> <eps>	_
NOUN ADP PROPN PROPN	RUE DE SABEL BARJAC	RUE DE SABELLE BARJAC	_
CCONJ ADJ ADP DET NOUN	MAIS PARFOIS SUR LA COMPARAISON	MAIS PARFOIS SUR LA COMPARAISON	_
ADV AUX NOUN ADJ	C EST PAS JUSTE	C EST PAS JUSTE	_
PRON PRON VERB	ÇA SE POURRAIT	ÇA CE POURRAIT	_
AUX PRON VERB VERB PRON	ON L AIMAIT MALGRÉ TOUT	ON LES MÊME MALGRÉ TOUT	_
NOUN ADP DET NOUN	FEU DANS LA CHEMINÉE	FEUX DANS LA CHEMINÉE	_
NOUN AUX AUX NOUN	VOILÀ QUI EST VRAI	VOILÀ QUI EST VRAI	_
PRON PRON VERB DET NOUN	IL NE FAIT QUE MANGER	IL NE FAIT QUE MANGER	_
AUX AUX ADJ NOUN	JE M APPELLE RAJA	JE M APPELLE RAJAT	_
PROPN AUX NOUN ADV	C EST TROP TARD	C EST TROP TARD	_
AUX AUX NOUN ADV PRON	ON VA BIEN HAUT AINSI	ON VA BIEN OU AINSI	_
PRON VERB AUX PRON NOUN	IL DEVRA ÊTRE QUELQUE PART	IL DEVRA ÊTRE QUELQUE PART	_
PRON PRON VERB ADJ ADP NOUN NOUN	IL NE FAIT PAS BEAU AUJOURD HUI	IL NE FAIT PAS BEAU AUJOURD HUI	_
ADV VERB ADP NOUN ADP NOUN	ELLES SONT EN TRAIN DE COURRIR	ELLES SONT EN TRAIN DE COURIR	_
AUX VERB ADV PRON NOUN ADP NOUN	ON PEUT MÊME LE TROUVER EN PELUCHE	ON PEUT MÊME LE TROUVER EN PELUCHE	_
VERB DET ADJ NOUN NOUN	ATTENDEZ UN PETIT MOMENT TÉLÉPHONE	RÉPONDEZ ACTIVEMENTER CÉLÉBRE <eps> <eps>	_
DET NOUN VERB NOUN	SES PARENTS SONT SÉPARÉS	SES PARENTS SONT SÉPARÉS	_
ADP SCONJ PRON VERB	POUR QUE NOUS PÊCHIONS	POUR QUE NOUS PÊCHIONS	_
DET NOUN ADP NOUN ADP NOUN DET NOUN	DES POMMES DE TERRE EN ROBE DES CHAMPS	DE POMMES DE TERRE EN ROBE DES CHAMPS	_
ADV AUX ADJ NOUN	C EST LÀ QU	C EST LA CLÉ	_
ADV AUX VERB SCONJ PRON VERB	TU ES SÛR QUE NOUS AIMERONS	TU ES SÛR QUE NOUS AIMERONS	_
NOUN DET NOUN	MAINTENANT IL PÊCHE	MAINTENANT ELLE PÊCHENT	_
PRON PRON VERB DET NOUN ADJ NOUN	IL Y A DES MALADES PARMI ELLES	IL Y A DES MALADES PARMI ELLES	_
ADJ NOUN ADP NOUN <eps>	TROIS VILLAGE DE LAFONTASSE <eps>	TROIS VILLAGES DE LA FONTASSE	_
ADP PRON DET NOUN	POUR QU IL PÊCHE	POUR QU ILS PÊCHENT	_
<eps> DET ADJ NOUN	<eps> UN PAUVRE IMBÉCILE	COMPRENDRE UN DOSSIER <eps>	_
NOUN NOUN ADP DET PRON NOUN	DITES MOI S IL VOUS PLAIT	DITES MOI S IL VOUS PLAIT	_
ADP ADJ NOUN PRON VERB NOUN	C EST TOI QUI L A	C EST AU QUI L A	_
NOUN DET ADJ NOUN	INVITÉS DES DEUX SEXES	INVITÉS DES DEUX SEXES	_
PRON VERB PRON VERB	QU AVEZ VOUS DONC	QU AVEZ VOUS DONC	_
PROPN ADP NOUN	MÈRE DE LAMINE	MAIRE DE LAMINE	_
PRON VERB VERB PRON ADV	ELLE SERA AVEC NOUS DEMAIN	ELLE SERA AVEC NOUS DEMAIN	_
CCONJ ADP NOUN ADP NOUN	ET J ACHÈVERAI MON DEVOIR	IL ESTCHÉRAIT <eps> MON DEVOIR	_
PROPN AUX DET NOUN NOUN ADP NOUN	C EST UNE BELLE COUPE DE FILLE	C EST UNE BELLE COUPE DE FILLE	_
ADJ ADP PRON PRON VERB	FAITES COMME JE VOUS DIS	FAITES COMME JE VOUS DIS	_
PRON PRON VERB DET NOUN ADP NOUN	IL Y A DES RICHES À ETEL	IL Y A DES RICHES À TELS	_
DET AUX CCONJ NOUN	IL EN A BESOIN	IL EN A BESOIN	_
ADV PRON NOUN <eps> VERB ADJ	TU NE MANGES <eps> PAS ASSEZ	CE NE M ENGE PAS ASSEZ	_
ADP PRON PRON VERB PRON	AVEC QUOI VOUS DIVERTISSEZ VOUS	AVEC QUOI VOUS DIVERTISSEZ VOUS	_
NOUN VERB PROPN NOUN	SON FOND EST PLAT	SON FOND EST PLAT	_
DET NOUN AUX NOUN	LA MAISON EST JOLIE	LA MAISON EST JOLIE	_
ADP AUX NOUN	OÙ EST ELLE	OÙ EST ELLE	_
PRON AUX ADJ NOUN VERB ADV	IL EST CAPABLE OUI OU NON	IL EST CAPABLE OUI OU NON	_
ADV AUX ADV ADV	NON JE SUIS LÀ	NON JE SUIS LÀ	_
DET NOUN NOUN	LA FAILLITE MENAÇAIT	LA FAILLITE MENACÉE	_
PRON VERB ADJ NOUN	NE VIENS PAS ICI	NE VIENT PAS ICI	_
ADV VERB VERB ADP DET NOUN	NE CRAIGNEZ RIEN POUR MA SANTÉ	NE CRAIGNEZ RIEN POUR MA SANTÉ	_
DET NOUN CCONJ NOUN	IL TRÉPIGNE D IMPATIENCE	IL TRÉPIGNE D IMPATIENCE	_
X NOUN ADJ ADJ NOUN	J AI ÉTÉ DIPLÔMÉ MAIS	J ÉTAIS <eps> DIPLÔMÉ MAIS	_
PRON PRON AUX NOUN	QU IL EST BÊTE	KHILL <eps> <eps> BÊTE	_
PRON VERB DET NOUN NOUN	CE FUT UN GROS TRAVAIL	CE FUT UN GROS TRAVAIL	_
AUX ADP NOUN ADV	JE L AIME ENCORE	JE L AIME ENCORE	_
PRON VERB NOUN	NE BOUGEZ PAS	NE BOUGEEZ PAS	_
PRON ADV PRON VERB NOUN	VOUS NE LE SAVIEZ PAS	VOUS NE LE SAVIEZ PAS	_
DET ADJ AUX NOUN	UN AUTRE EST FUSILLÉ	UN AUTRE EST FUSILLÉ	_
PRON VERB DET ADJ NOUN	IL VA LE TUER ROXANE	IL VA LE TUER ROXANE	_
AUX ADV VERB ADJ ADJ NOUN	ON NE PEUT PAS DIRE ÇA	ON NE PEUT PAS DIRE ÇA	_
NOUN DET NOUN NOUN	PUIS IL APPELA GAVROCHE	PHILIPPE IL APPELA GAVROCHE	_
PRON AUX PRON SCONJ PRON AUX PROPN	QU EST CE QUE C EST MOI	QU EST CE QUE C EST MOI	_
VERB NUM NOUN	VINGT QUATRE HEURES	VINGT QUATRE HEURES	_
PRON ADV AUX ADJ ADP PRON	IL N EST PAS AVEC VOUS	IL N EST PAS AVEC VOUS	_
PRON PRON AUX ADJ ADJ	ÇA C EST ÊTRE CONNU	ÇA C EST ÊTRE CONNU	_
PROPN AUX ADJ NOUN	C EST DÉJÀ FAIT	C EST DÉJÀ FAIT	_
PRON PRON VERB NOUN	ELLE NE RÉPONDIT PAS	ELLE NE RÉPONDIT PAS	_
PROPN AUX DET NOUN	C EST DU CAPORALISME	C EST LE CRAPOVALISME	_
ADP NOUN PRON NOUN	L HEURE DU DÎNER	L HEURE DU DÎNER	_
VERB ADJ NOUN	ASSUMEZ VOS CHOIX	ASSUNEZ VOS CHOIX	_
PRON VERB PRON VERB	QU AVEZ VOUS OUVERT	QU AVEZ VOUS OUVERT	_
AUX VERB VERB ADJ ADJ NOUN	ON N A PAS ÉTÉ DÉÇUS	ON N A PAS ÉTÉ DÉÇU	_
NOUN DET NOUN	RÉPARTISSONS LES CHOSES	REPARTISSONS LES CHOSES	_
CCONJ DET NOUN VERB DET NOUN	ET LA LAISSER PRENDRE LA SUITE	IL A LAISSÉ PRENDRE LA SUITE	_
PRON VERB ADP DET NOUN	JE SUIS À LA FENÊTRE	JE SUIS À LA FENÊTRE	_
DET NOUN ADP DET NOUN VERB NOUN	LE MINISTÈRE DE LA SANTÉ RESTE VACANT	LE MINISTÈRE DE LA SANTÉ RESTE VACANT	_
DET NOUN NOUN	SA CARRIÈRE DÉBUTE	SA CARRIÈRE DÉBUTE	_
ADV VERB PRON ADJ DET NOUN	TU ES SÛR QU IL AIME	TU ES SÛR QU IL AIMAIT	_
PROPN VERB PROPN <eps>	C ÉTAIT LOUIS <eps>	C EST ELLE OUI	_
PRON ADV DET NOUN	SI JE LE SAIS	SI JE LE SAIS	_
ADV PRON AUX DET ADJ NOUN	NON C EST LA PREMIÈRE FOIS	NON C EST LA PREMIÈRE FOIS	_
PRON AUX ADJ NOUN ADP DET NOUN NOUN	IL A FAIT PARTIE DE LA FRANC MAÇONNERIE	IL <eps> FAIT PARTIE DE LA FRANC MAÇONNERIE	_
PROPN VERB ADJ NOUN	C EST TRÈS DISCUTABLE	C EST TRÈS DISCUTABLE	_
ADP NOUN ADP PROPN	J AIME L ANGLAIS	J AIME L ANGLAIS	_
ADV AUX NOUN NOUN ADP PROPN	TU ES PARENT AVEC M MOHAN	SUÉ <eps> PARENT AVEC MONSIEUR MOINE	_
NOUN VERB DET NOUN	ELLE AIMERAIT TA SŒUR	ELLE AIMERAIT TA SŒUR	_
NOUN NOUN ADP DET NOUN	DONNONS LUI DE L OCCUPATION	DONNANT LUI DE L OCCUPATION	_
SCONJ DET NOUN AUX ADV ADP ADJ NOUN	QUE LE TEMPS EST BEAU DANS TON PAYS	QUE DE TEMPS EST BEAU DANS MON PAYS	_
PRON NOUN ADP NOUN ADP NOUN ADJ	IL JOUA D ABORD AU THÉÂTRE ITALIEN	IL JOUA D ABORD AU THÉÂTRE ITALIEN	_
AUX NOUN ADP NOUN	JE VAIS À TABLE	JE VAIS ATTABLE <eps>	_
ADP DET ADJ NOUN	A LA BONNE HEURE	À LA BONNE HEURE	_
ADJ NOUN ADP DET NOUN	SEPT RUE DE LA MARTINELLE	SEPT RUE DE LA MARTINEN	_
PROPN DET NOUN	MARY ET ST	MARIE ET ST	_
NOUN PRON PRON AUX ADV	CERTES SI VOUS RESTEZ LÀ	CERTES SI VOUS RESTEZ LÀ	_
PRON VERB ADV DET NOUN	VOUS CONNAISSEZ PARFAITEMENT LES LIEUX	VOUS CONNAISSEZ PARFAITEMENT LES LIEUX	_
AUX VERB VERB VERB NOUN	ON NE SAIT FIT BRIENNE	ON NE SAIT FIBRIENNE <eps>	_
PRON VERB DET NOUN ADJ	ELLE POURSUIT UNE CARRIÈRE MUSICALE	ELLE POURSUIT UNE CARRIÈRE MUSICALE	_
NOUN ADP NOUN NOUN NOUN ADP NOUN	J Y AI RÉUSSI JUSQU À PRÉSENT	J Y AI RÉUSSI JUSQU À PRÉSENT	_
DET ADJ ADJ	LE PLUS ANCIEN	LE PLUS ANCIEN	_
ADV VERB NOUN NOUN	MAIS REGARDE MOI DONC	MAIS REGARD MOI DONC	_
PRON DET NOUN	JE LES IGNORAIS	JE LES IGNORAIS	_
DET AUX NOUN	IL LUI PARDONNE	IL LUI PARDONNE	_
PROPN AUX ADJ NOUN	C EST LÀ BAS	C EST LÀ BAS	_
PRON ADV PRON NOUN ADP PROPN	VOUS ÊTES SI BONNE POUR MOI	VOUS ÊTES SI BONNE POUR MOI	_
PRON VERB ADV DET NOUN	QUI LISAIT ENCORE DES LIVRES	QUI LISAIT ENCORE DES LIVRES	_
VERB NOUN PRON NOUN	CET ENDROIT ME PLAIT	CET ENDROIT ME PLAÎT	_
PRON AUX ADV NOUN	ELLE ÉTAIT TROP ÉPOUVANTÉE	ELLE ÉTAIT TROMPE ÉPOUVANTÉE	_
PROPN NOUN NOUN	SIX RUE BRÈVE	CYRUBRÈVE <eps> <eps>	_
ADJ VERB ADP	QU ENTEND ON	QUANT EN TANT	_
PROPN VERB DET NOUN	C EST LES VACANCES	C EST LES VACANCES	_
VERB PRON ADP DET NOUN	DIT ELLE ENTRE SES DENTS	DIT ELLE ENTRE SES DENTS	_
PROPN AUX NOUN	ELLE EST CHAUDE	ELLE EST CHAUDE	_
ADJ NOUN ADP NOUN	BONNE ANNÉE À VOUS	BONNE ANNÉE À VOUS	_
ADV AUX DET NOUN DET NOUN	CAR JE LE CROIS TRÈS MALHEUREUX	CAR JE LE CROIT TRÈS MALHEUREUX	_
AUX PRON NOUN DET NOUN	EST CE QU IL VIENDRA	EST CE QU IL VIENDRA	_
NOUN AUX NOUN	CLÉMENCE EST RASÉE	CLÉMENCE EST RASÉ	_
NOUN PROPN PROPN NOUN	RUE JEAN GIRARD BOURGES	RUE JEAN GIRARD BOURGES	_
DET AUX NOUN	IL EST PARTI	IL EST PARTI	_
PRON VERB VERB	IL DOIT COMPRENDRE	IL DOIT COMPRENDRE	_
ADJ DET NOUN AUX ADP NOUN NOUN	TOUS LES PLANCHERS SONT EN BOIS DUR	TOUT LE PLANCHER SONT EN BOIS DIRE	_
DET NOUN ADP NOUN	LE RIDEAU S OUVRE	LE RIZ DE SOURD	_
PRON PRON AUX ADV ADP DET NOUN	CE N EST PLUS DE NOTRE ÉPOQUE	CE N EST PLUS <eps> NOTRE ÉPOQUE	_
PRON VERB SCONJ NOUN	SI PEU QUE RIEN	SI PACRURIUM <eps> <eps>	_
PROPN NOUN ADV AUX ADV ADV	SON CORPS N EST PAS LÀ	SON CORPS N EST PAS LÀ	_
X AUX ADJ VERB DET DET NOUN	J AI DEUX FRÈRES ET UNE SŒUR	J AI DEUX FRÈRES ET UNE SŒUR	_
DET PROPN PROPN	IL EST ICI	IL EST ICI	_
DET NOUN ADJ NOUN NOUN	UN PANTALON BEAUCOUP TROP SERRÉ	UN PANTALON BEAUCOUP TROP SERRÉ	_
NOUN ADP NOUN ADV	D OÙ VIENS TU	DE <eps> VIENS TU	_
DET NOUN AUX ADJ NOUN	LE JEU EST DÉSORMAIS FERMÉ	LE JEU EST DÉSORMAIS FERMÉ	_
PROPN PROPN VERB VERB DET NOUN	QUAND CELA SERA T IL PRÊT	QUAND CELA SERA T IL PRÈS	_
DET NOUN AUX NOUN	LA CHAISE EST CASSÉ	LA CHAISE EST CASSÉE	_
DET NOUN NOUN	LE TEMPS PASSÉ	LES THÈMES PASSAIENT	_
PROPN NOUN ADV PROPN ADP DET NOUN	PASSANT ENTENDS TU BÉGAYER À LA FOIS	PASSANT TANT TU BÉGAYER À LA FOIS	_
AUX VERB ADP DET NOUN	ON EST À L ORDRE	ON NAÎT À L ORDRE	_
PRON PRON VERB	VOUS VOUS AIMEZ	VOUS VOUS AIMEZ	_
ADP ADJ NOUN	C EST POURQUOI	C EST POURQUOI	_
AUX ADP CCONJ NOUN	JE L AI VU	JE L AI VU	_
DET NOUN DET ADJ NOUN	LE SORT LE PREMIER NUMÉRO	LE SORT LE PREMIER NUMÉRO	_
PRON AUX VERB SCONJ PRON VERB DET NOUN	C EST LUI QUE J AIME LE PLUS	C EST LUI QUE J AIME LE PLUS	_
ADP PROPN ADJ NOUN	L AFFAIRE SERA CHAUDE	L AFFAIRE SERA CHAUDE	_
PROPN DET ADJ NOUN <eps>	C EST COMPLÈTEMENT DÉBILE <eps>	C EST COMPLÈTEMENT DES VILLES	_
DET NOUN VERB DET VERB ADV	LE VIEUX N EN DORMAIT PLUS	LE VIEUX N ONT DORMI PLUS	_
ADV ADJ VERB <eps>	HIER ELLE PÊCHAIT <eps>	HIER C EST DÉPÊCHÉ	_
DET NOUN DET NOUN	AU PROFIT DES GRECS	AU PROFIT DES GRECS	_
AUX PRON ADP ADJ NOUN	JE N EN SAIS RIEN	JE N EN SAIS RIEN	_
NOUN PROPN NOUN NOUN	D AUTRES ANIMAUX JAUNES	D AUTRES ANIMAUX JAUNES	_
PRON VERB ADJ NOUN	JE SUIS EXTRÈMEMENT SATISTFAIT	JE SUIS EXTRÊMEMENT SATISFAIT	_
DET NOUN VERB ADP VERB DET NOUN	UN DÉCRET POURRAIT EN PRÉCISER LA DÉFINITION	UN DÉCRET POURRAIT EN PRÉCISER LA DÉFINITION	_
PRON PRON VERB ADV DET NOUN ADP DET NOUN	NE LUI OUVREZ PAS LA BOUCHE DE TOUT CELA	NE LUI OVRAIT PAS LA BOUCHE DE TOUT CELA	_
DET VERB ADJ	IL EST LÀ	IL EST LÀ	_
DET NOUN NOUN	ET ELLE VIENDRA	ET ELLE VIENDRA	_
PROPN AUX DET NOUN	LEQUEL EST VOTRE SAC	LEQUEL EST VOTRE SEC	_
NOUN ADP NOUN <eps> DET NOUN VERB ADP DET NOUN	JUSQU À MINUIT <eps> LA MAISON FUT EN L AIR	JUSQU À DE NUIT LA MAISON FUT EN L AIR	_
PRON AUX PRON SCONJ AUX VERB	QU EST CE QUE TU PENSES	QU EST CE QUE TU PENSES	_
ADP NOUN DET NOUN	À DEMAIN VOTRE HONNEUR	À DEMAIN VOTRE HONNEUR	_
DET NOUN VERB PRON	LE COMBIEN SOMMES NOUS	LE COMBIEN SOMMES NOUS	_
VERB DET ADJ NOUN	EMPRUNTEZ LA AVEC COURAGE	EMPRUNTEZ LÀ AVEC COURAGE	_
DET NOUN AUX DET ADJ NOUN	LA SYNAGOGUE EST AU DEUXIÈME ÉTAGE	LA SYNAGOGUE EST AU DEUXIÈME ÉTAGE	_
PRON PRON VERB CCONJ ADJ	VOUS EN AUREZ D AUTRES	VOUS EN AUREZ D AUTRES	_
PRON AUX NOUN ADP NOUN	IL EST FILS DE MÉDECIN	IL EST FILS DE MÉDECIN	_
PROPN ADJ NOUN	C EST SALE	C EST SALE	_
NOUN DET NOUN PROPN	CHEMIN DU GOURD MONTAGNAT	CHEMIN DU BOURG MONTAGNAT	_
PRON NOUN AUX VERB ADJ NOUN	TRÈS BIEN J AIME MIEUX ÇA	TRÈS BIEN J AIME MIEUX ÇA	_
ADP NOUN VERB	OH MERCI BEAUCOUP	OH MERCI BEAUCOUP	_
ADP NOUN VERB ADJ NOUN	L OUVRAGE A TROIS TRAVÉES	L OUVRAGE A TROIS TRAVÉES	_
NOUN NOUN PRON AUX DET NOUN	CET ARTICLE DEUX EST UNE RÉGRESSION	CET ARTICLE DEUX EST UNE RÉGRESSION	_
NOUN PRON AUX NOUN DET NOUN	PERSONNE N A OUBLIÉ LA CHIMÈRE	PERSONNE N A OUBLIÉ LA CHIMÈRE	_
NOUN ADP NOUN ADP NOUN	MISE EN SCÈNE DE MOCKER	MISE EN SCÈNE DE MOKER	_
PROPN NOUN AUX PRON NOUN	SON FONCTIONNEMENT EST LE SUIVANT	SON FONCTIONNEMENT EST LE SUIVANT	_
PRON AUX VERB DET NOUN	JE LUI ÉCRIVIS UNE LETTRE	JE LUI ÉCRIVIS UNE LETTRE	_
PRON AUX PRON VERB DET NOUN	JE VEUX VOUS DONNER UN CADEAU	JE VAIS VOUS DONNER UN CADEAU	_
PRON AUX VERB ADP NOUN	IL EST DISSOUS DE FAIT	IL EST DISSOUS DE FAIT	_
NOUN AUX AUX VERB DET NOUN	RÉCEMMENT J AI VU UN HOMME	RÉCEMMENT J AI VU UN HOMME	_
PRON NOUN ADV NOUN ADP PRON NOUN	JE SOUTIENS L AMENDEMENT DE MONSIEUR LAURENT	JE SOUTIENS L AMENDEMENT DE MONSIEUR LAURENT	_
NOUN ADP VERB NOUN <eps>	MÂTIN ÇA SENT BON <eps>	MATIN ÇA S EN NOM	_
PRON NOUN VERB PRON ADP NOUN	JE SUIS SÛR QUE J AIME	JE SUIS SÛR QU ILS AIME	_
DET ADJ NOUN ADV VERB AUX NOUN	LES DEUX LIMITES NE PEUVENT ÊTRE ATTEINTES	LES DEUX LIMITES NE PEUVENT ÊTRE ATTEINTES	_
ADP ADJ NOUN CCONJ NOUN NOUN NOUN	T ES VRAIMENT UN GROS CON ENGUERRAND	DES <eps> VRAIMENT <eps> GROS CONVIRONS <eps>	_
PRON AUX VERB ADJ	JE SUIS TRÈS STRICT	JE SUIS TRÈS STRICT	_
NOUN ADP PROPN	ALLER À MADAGASCAR	ALLER À MADAGASCAR	_
ADJ VERB DET NOUN ADP PROPN	BELLE ROSE LE CONDUISIT À SUZANNE	BELLE ROSE LE CONDUISIT À SUZANNE	_
PRON VERB ADP DET ADJ NOUN	ELLE MARCHE DANS L HERBE RASE	ELLE MARCHE DANS L HERBE RAZE	_
DET NOUN AUX ADJ <eps>	IL PARAISSAIT M ÉVITER <eps>	IL PARAÎT ASSEZ MAIS EUSTÉ	_
NOUN NOUN NOUN AUX DET NOUN ADP PROPN	SON CHEF LIEU EST LA VILLE DE GARZA	SON CHEF LIEU EST LA VILLE DE GARZA	_
PRON VERB CCONJ ADJ NOUN	VOUS AVEZ D EXCELLENTES LECTURES	VOUS AVEZ D EXCELLENTE LECTURE	_
PRON PRON ADP DET ADJ NOUN	IL Y A UNE AUTRE RAISON	IL Y A UNE AUTRE RAISON	_
ADV ADP NOUN ADP PROPN NOUN	TU AS RAISON DE RESTER GARÇON	TU AS RAISON DE RESTER GARÇONS	_
ADV VERB PRON ADP NOUN	EH BIEN LE N HUIT	EH BIEN LE NUMÉRO HUIT	_
NOUN DET PRON VERB	CERTES IL VOUS AIME	CERTES IL VOUS AIME	_
PROPN AUX DET NOUN ADP NUM NOUN	DELPHINE SONT DES HOMMES DE SIX COUDÉES	DELPHINE SONT LES HOMMES DE SIX COUDÉS	_
PRON AUX VERB VERB ADJ ADP NOUN	IL M AVAIT DIT CELA EN RIANT	IL M AVAIT DIT CELA EN RIANT	_
PROPN AUX NOUN	C EST RIDICULE	CES RIDICULES <eps>	_
PROPN AUX NOUN PRON DET NOUN	C EST CELUI CI LE TIEN	C EST CELUI CI LE TIENT	_
PRON VERB ADV	CE SONT LESQUELLES	CESSANT REQU ELLES	_
PRON AUX ADV PRON SCONJ PRON VERB ADP NOUN	C EST POURTANT CE QUE VOUS FAITES EN PERMANENCE	C EST POURTANT CE QUE VOUS FAITES EN PERMANENCE	_
CCONJ AUX VERB DET ADJ NOUN	MAIS JE CITERAI UN SEUL EXEMPLE	MAIS JE CITERAI UN SEUL EXEMPLE	_
NOUN SCONJ PROPN	RIEN QUE CELA	RIEN QUE CELA	_
PRON AUX NOUN DET NOUN	IL EST PERDU LE GARÇON	IL EST PERDU LE GARÇON	_
PRON AUX DET ADJ NOUN	C EST UNE GROTTE PRIVÉE	C EST UNE BROADGE PRIVÉE	_
PRON AUX VERB DET NOUN	J AI ADORÉ CE FILM	J AI ADORÉ CE FILM	_
NOUN CCONJ ADV	DEMAIN OU HIER	DEMAIN UNE GUERRE	_
PRON PRON ADP DET NOUN ADP NOUN	IL Y A UNE ÉCOLE DE LANGUES	IL Y A UNE ÉCOLE DE LANGUES	_
NOUN PRON VERB ADV VERB NOUN	ELLE LUI DIT TU SERAS PENDU	ELLE LUI DIT CERA PENSE <eps>	_
DET NOUN ADP NOUN	QUEL ÂGE AS TU	QUEL ÂGE AS TU	_
ADV VERB AUX NOUN SCONJ PRON ADP PRON ADP NOUN ADP NOUN	EH BIEN JE VERRAI QU IL N Y A RIEN À VOIR	HÉBERGÉ <eps> <eps> <eps> QU IL N Y <eps> RIEN D AVOIR	_
ADP NOUN DET NOUN	À ENCOURAGER LA CROISSANCE	À ENCOURAGER LA CROISSANCE	_
NOUN ADP PROPN	UNIVERSITÉ DE LAVAL	UNIVERSITÉ DE LAVAL	_
PROPN PROPN ADV VERB DET NOUN ADP	TOI AUSSI TU ES DE CEUX LÀ	TOI AUSSI TU ES DE CELA <eps>	_
NOUN ADJ ADJ NOUN	D AUTRES GRANDES CHAISES	D AUTRES GRANDES CHAISES	_
NOUN VERB DET NOUN NOUN	RUE PELLETAN AU NUMÉRO SEPT	RUE PELLETAN AU NUMÉRO SEPT	_
AUX VERB ADJ ADV	ON TE VERRA DEMAIN	ON TE VERRA DEMAIN	_
PRON VERB ADJ NOUN ADP NOUN	IL FUT DOUBLE DISQUE D OR	IL FUT DOUBLE DISQUE D OR	_
PRON ADJ NOUN DET NOUN	IL DESSINE AUSSI DES MEUBLES	IL DESSINE AUSSI DES MEUBLES	_
PRON VERB ADV NOUN	ELLE REVIENT VERS ANTOINE	ELLE REVIENT VERS ANTOINE	_
PROPN AUX DET NOUN ADP NOUN	C EST LA FAUTE DE QUI	C EST LA FAUTE DE QUI	_
AUX VERB AUX NOUN	ON L A FRAPPÉ	ON L A FRAPPÉ	_
PROPN VERB DET NOUN	C EST UNE EXPERTE	C EST UNE EXPERTE	_
DET NOUN AUX NOUN	EN BREF JE DÉMISSIONNE	EN BREF JE DÉMISSIONNE	_
AUX VERB SCONJ PRON ADJ VERB <eps> ADP DET PROPN	EST CE QUE ÇA LUI COÛTE <eps> DE L ARGENT	EST CE QUE C EST L ÉCOUTE DE L ARGENT	_
NOUN NOUN NOUN	ÉGLISE SAINT CLÉMENT	ÉGLISE SAINT CLÉMENT	_
NOUN PRON VERB ADP NOUN ADP ADJ NOUN	OBJECTIVEMENT C EST UN TRAVAIL DE LONGUE HALEINE	<eps> C EST LE TRAVAIL DE LANGUEDALE <eps>	_
PRON AUX ADV PROPN ADJ NOUN	ELLE EST AUJOURD HUI TOTALEMENT IGNORÉE	ELLE EST AUJOURD HUI TOTALEMENT IGNORÉE	_
ADV ADV DET NOUN VERB	PAS MÊME LE CAPITAINE NEMO	PAS MÊME LE CAPITAINE NEMO	_
DET NOUN VERB DET NOUN AUX NOUN	L ENFANT DONT LE BRAS EST CASSÉ	L ENFANT DANS LE BRUN EST CASSIS	_
ADP PRON NOUN ADP DET NOUN	ON LES TROUVE DANS LES PLANTES	ON LES TOMBE DANS LES PLANS	_
NOUN AUX ADV NOUN	ELLE EST TROP BELLE	ELLE EST TROP BELLE	_
PROPN NOUN DET PROPN DET ADP PROPN	SANS COMPTER LA YOUGOSLAVIE ET L EGYPTE	SANS COMPTER LA YOUGOSLAVIE DE L ÉGYPTE	_
PRON NOUN ADP NOUN ADP PRON NOUN PRON VERB ADP NOUN	N Y A QU À NE PAS SE METTRE EN SERVICE	N Y A QU À <eps> <eps> SE METTRE EN SERVICE	_
PROPN AUX ADJ ADP DET NOUN	C EST RESPECTUEUX DE L ENVIRONNEMENT	C EST RESPECTUEUX DE L ENVIRONNEMENT	_
PRON VERB VERB SCONJ PRON VERB	JE SUIS SÛR QUE VOUS AIMÂTES	JE SUIS SÛR QUE VOUS AIMÂTES	_
ADV ADV VERB DET NOUN	MAIS POUR SOULIGNER TES RATAGES	MAIS POUR SOULIGNY THÉRATAGE <eps>	_
VERB PRON NOUN	JE ME PERDS	JE M EMPEREUR	_
NOUN AUX PRON SCONJ PRON VERB	COMBIEN EST CE QUE ÇA COÛTERA	COMBIEN <eps> CE QUE ÇA COÛTERA	_
NOUN DET NOUN PROPN DET NOUN	SEUL LE DOCTEUR BREUER LE SOUTIENT	SEULS D AUTRES BROEEURS LE SOUTIENT	_
PRON VERB DET NOUN ADP DET NOUN	JE SUGGÈRE LE RETRAIT DE CES AMENDEMENTS	JE SUGGÈRE LE RETRAIT DE CES AMENDEMENTS	_
DET NOUN NOUN	LA MACHINE FONCTIONNE	LA MACHINE FONCTIONNE	_
ADV PRON ADP NOUN	QUI VOUS A TÉLÉPHONÉ	QUI VOUS A TÉLÉPHONÉ	_
CCONJ NOUN PRON AUX NOUN	ET PUIS IL ÉTAIT MINISTRE	ET PUIS IL ÉTAIT MINISTRE	_
VERB ADJ NOUN	VINGT TROIS TABLES	VINGT TROIS TABLES	_
DET PROPN NOUN DET PROPN	DE JANE MOUTON ET AL	DE JEANNES MOUTONS ET ARLES	_
PRON DET NOUN ADP ADJ NOUN	IL LA MET DANS SON GOUSSET	IL LA MET DANS SON GOUSSET	_
NOUN DET ADJ NOUN ADP NOUN	PLACE DE L ALLÉE À SEIX	CLASSE DE L ALLÉE À SEXE	_
DET NOUN ADP NOUN	LA FÉDÉRATION DE RUSSIE	LA FÉDÉRATION DE RUSSIE	_
VERB AUX DET NOUN PRON	PEUT ÊTRE LE SAIT ELLE	PEUT ÊTRE LE CENTRE <eps>	_
DET NOUN VERB DET NOUN ADP NOUN	LA PRINCIPAUTÉ PREND LE NOM DE SARUHAN	LA PRINCIPAUTÉ PREND LE NOM DE SARUHEN	_
ADP NOUN ADP NOUN NOUN	L HOMME D AFFAIRE RÉAGIT	L HOMME D AFFAIRES RÉAGIT	_
ADV ADP AUX ADV DET NOUN NOUN	MAIS OÙ EST DONC LE PÈRE UBU	MAIS OÙ EST DONC LE PÈRE UBU	_
DET NOUN NOUN	LES QUATRE GROS	LES QUATRE GROS	_
NOUN ADJ NOUN	MAINTENANT TU PÊCHES	MAINTENANT TU PÊCHES	_
DET NOUN DET NOUN NUM	LE RETAIL AU NUMÉRO QUATRE	LE RETAIL AU NUMÉRO QUATRE	_
NOUN NOUN AUX NOUN ADJ NOUN	CERTAINS N ONT JAMAIS ÉTÉ RECONSTRUIT	CERTAINS N ONT JAMAIS ÉTÉ RECONSTRUITS	_
NOUN ADP NOUN PART NOUN CCONJ	PERSONNE D AUTRE NE SAIT ÇA	PERSONNE D AUTRE NE CESSA <eps>	_
DET NOUN VERB DET NOUN	LE VILLAGE COMPTE UNE ÉGLISE	LE VILLAGE COMPTE UNE GLISME	_
PRON VERB ADP DET NOUN CCONJ DET NOUN	VOUS AUREZ DE L EAU OU DU CAFÉ	VOUS AUREZ DELOS <eps> <eps> OU DU CAFÉ	_
ADP DET ADJ NOUN	DANS CETTE SOMBRE IMMENSITÉ	DANS CETTE SOMBRE IMMENSITÉ	_
VERB PRON ADJ NOUN	AH NOUS SOMMES PROPRES	AH NOUS SOMMES PROPRES	_
DET NOUN AUX ADJ	LES VALVES SONT SUSPENDUES	LES VALVES SONT SUSPENDUES	_
PRON ADV AUX NOUN	NOUS AVONS ÉTÉ AIMÉS	NOUS AVONS ÉTÉ AIMÉS	_
NOUN NOUN NOUN ADJ NOUN	C EST SON PREMIER ALBUM	C EST SON PREMIER ALBUM	_
ADP DET NOUN PRON PRON ADP ADJ NOUN	À LA MAISON IL Y A TROIS TÉLÉVISEURS	À LA MAISON IL Y A TROIS TÉLÉMISEURS	_
ADP DET NOUN	SUR LE TREIZIÈME	SUR LE TREIZIÈME	_
DET NOUN AUX NOUN	LA ZÉLÉE EST COULÉE	LA ZÉLÉE EST COULÉE	_
PRON PRON ADV ADV ADP NOUN	NOUS N AVONS PAS À ROUGIR	NOUS N AVONS PAS À ROUGIR	_
ADV ADV ADP VERB AUX DET NOUN	QUAND DONC EN VERRAI JE LA FIN	QUAND DONC ENVIRÈGE <eps> <eps> LA FIN	_
VERB NOUN ADJ NOUN	SA SAVEUR EST ÂCRE	SA SAVEUR EST ÂCRE	_
PRON VERB ADV ADV DET NOUN PRON AUX ADV NOUN	ON COMPREND MIEUX POURQUOI CETTE LOI N EST PAS APPLIQUÉE	ON COMPREND MIEUX POURQUOI CELA <eps> N EST PAS APPLIQUÉ	_
NOUN NOUN NOUN	DEUX MAISONS BLANCHES	DE MAISON BRANCHES	_
NOUN ADV PRON SCONJ PRON ADJ VERB	VOILÀ JUSTEMENT CE QUE NOUS VOULONS APPRENDRE	VOILÀ JUSTEMENT CE QUE NOUS VOULONS APPRENDRE	_
AUX DET NOUN NOUN	ON A L HABITUDE	ON A L HABITUDE	_
NOUN VERB DET NOUN	VENGEONS NOUS DU BOUFFON	VENGEONS NOUS DU BOUFFON	_
PRON AUX NOUN ADP DET NOUN	IL ÉTAIT MAL À L AISE	IL ÉTAIT MAL À L AISE	_
NOUN ADP DET NOUN	VOICI POUR LES DÉPENSES	VOICI POUR LES DÉPENSES	_
PRON VERB DET ADJ NOUN	JE PRENDRAI LA MÊME CHOSE	JE PRENDRAI LA MÊME CHOSE	_
ADP NOUN VERB DET NOUN	J AIMAIS MIEUX LES CHEVAUX	J AIMAIS BIEN LES CHEVAUX	_
PRON NOUN ADP DET VERB ADP NOUN NOUN	NOUS MARCHERONS DANS L HERBE À PAS SILENCIEUX	NOUS MARCHERONS DANS L HERBE À PAS SILENCIEUX	_
PROPN NOUN AUX PRON NOUN	EH BIEN EST IL RÉVEILLÉ	LES BIENS FÊTIRENT ÉVEILLÉS <eps>	_
ADP NOUN AUX NOUN	L AFFRONTEMENT ÉTAIT INÉVITABLE	L AFFRONTEMENT ÉTAIT INÉVITABLE	_
NOUN ADP NOUN	RIEN D AUTRE	RIEN D AUTRE	_
ADP NOUN ADJ NOUN NOUN	L ADRESSE CINQ RUE DESROUSSEAUX	L ADRESSE CINQ RUE DESROUSSOUS	_
VERB NOUN DET NOUN PRON ADV VERB NOUN	DONNEZ LUI DES VÊTEMENTS QUI NE GRATTENT PAS	DONNEZ LUI DES VÊTEMENTS QUI NE GRATTE PAS	_
ADJ PRON ADJ VERB	YVONNE QUI VEUT ÉCOUTER	YVONNE QUI VEUT ÉCOUTER	_
DET NOUN NOUN	IL TRAVAILLE MAL	IL TRAVAILLE MAL	_
PRON VERB ADP NOUN ADP NOUN	ÇA AUGMENTE D HEURE EN HEURE	ÇA AUGMENTE D HEURES HONNEURS <eps>	_
PROPN PROPN NOUN	DEMAIN ELLES PÊCHERONT	DEMAIN ELLE PÊCHERA	_
DET NOUN AUX PRON NOUN	TA FILLE EST ELLE PRÉVENUE	SA FILLE EST ELLE PRÉVENUE	_
PRON PRON PRON NOUN	VOUS NE PRENEZ RIEN	VOUS NE PRENEZ RIEN	_
VERB PROPN DET NOUN	APERCEVANT EDGARD AU FOND	APERCEVANT EDGARD AU FOND	_
VERB ADJ NOUN VERB PRON	ES TU MALADE DEMANDÉ JE	ET TU MALADES DE MAUVAISGE	_
NOUN DET NOUN	FAITES LE TOUR	PASSE LE TOURNOI	_
DET NOUN ADJ	UN BILLET ALLER	UN BILLET ALLEZ	_
DET NOUN ADJ NOUN	LE COMMISSAIRE TRÈS BIEN	LE COMMISSAIRE TRÈS BIEN	_
NOUN ADP PRON VERB NOUN	PERSONNE N Y COMPREND RIEN	PERSONNE N Y COMPREND RIEN	_
VERB ADV NOUN ADP ADV PRON NOUN	PEUT ÊTRE VIENDRA T ELLE QUI SAIT	HÔTEL <eps> VIENDRA T ELLE QUI SAIT	_
PRON AUX VERB ADP DET ADJ NOUN	IL EST NÉ DANS LES HAUTES ALPES	IL EST NÉ DANS LES HAUTES ALPES	_
PRON AUX ADJ	IL EST ENTERRÉ	IL EST ENTERRÉ	_
ADV VERB PRON ADJ ADP NOUN	TU ES SÛR QU ON AIME	TU ES SÛR QU ON AIME	_
DET NOUN NOUN	LA POURSUITE CONTINUE	LA POURSUITE CONTINUE	_
AUX VERB NOUN ADP ADJ DET NOUN	ON PEUT AUSSI Y FAIRE DU PARAPENTE	ON PEUT AUSSI <eps> FAIRE DU PARAPENTE	_
PRON PRON CCONJ DET NOUN <eps> ADJ NOUN	IL Y A DES MALADES <eps> PARMI EUX	IL Y A DES MALHEURS À PARMI EUX	_
SCONJ PRON VERB ADP NOUN ADP DET NOUN	QU ELLE GARDA EN TRAVERS DE LA GORGE	QU ELLE GARDA EN TRAVERS DE LA GORGE	_
PRON VERB NOUN DET NOUN DET NOUN	IL POURSUIT ENSUITE SES ÉTUDES DE DROIT	IL POURSUIT ENSUITE SES ÉTUDES DE DROIT	_
NOUN ADJ ADJ	DEUX TABLES NOIRES	DEUX TABLES NOIRES	_
PRON VERB ADP DET NOUN ADP DET NOUN DET NOUN	JE VIENS DE LA METTRE À LA PORTE VOTRE JEANNETTE	JE VIENS DE LA METTRE À LA PORTE VOTRE GENNETTE	_
PRON VERB SCONJ PRON VERB ADV	IL FAUT QUE JE TRAVAILLE PLUS	IL FAUT QUE JE TRAVAILLE PLUS	_
DET NOUN ADP NOUN	LA CONVERSATION S ÉGARA	LA CONVERSATION S ÉGARA	_
NOUN VERB ADP NOUN <eps> <eps>	ELLE VIT À FELDAFING <eps> <eps>	ELLE VIT À CELLE D AFFIGNE	_
ADV VERB DET NOUN VERB NOUN	C EST MON CAS CE SOIR	C EST MON CAS CE SOIR	_
PRON AUX PRON SCONJ PRON VERB NOUN	QU EST CE QUE VOUS FAITES DIMANCHE	QU EST CE QUE VOUS FAITES DIMANCHE	_
NOUN ADP NOUN ADP PROPN	RUE D ELBINGERODE À BOULIGNY	RUE DELBENJERODE <eps> À BOULIGNY	_
DET NOUN PRON VERB	IL OBJECTE IL RÉSISTE	IL OBJECTE IL RÉSISTE	_
DET NOUN VERB DET NOUN	LE DOIGT MARQUE LA DIRECTION	JE DOIS MARQUE LA DIRECTION	_
PROPN PRON AUX ADV ADP NOUN PRON PRON ADP ADV VERB ADV DET NOUN	CELA N A PAS DE FIN SI L ON DOIT INVITER TOUT LE MONDE	CELA N A PAS DE FIN SI L ON DOIT ÉVITER TOUT LE MONDE	_
DET NOUN NOUN	LA TOURTERELLE MÂLE	LA TOURTERELLE MÂLE	_
